Image Name,Crack Area,Pothole Area,Total Damage Area,State,Highway
1007607_RS_386_386RS289112_28960.jpg,4005,104,4109,RS,386
1014609_RS_386_386RS124739_29970.jpg,9674,0,9674,RS,386
1014623_RS_386_386RS124739_30040.jpg,5213,0,5213,RS,386
1014628_RS_386_386RS124739_30065.jpg,37399,1587,38986,RS,386
1014629_RS_386_386RS124739_30070.jpg,28635,200,28835,RS,386
1014650_RS_386_386RS124739_30175.jpg,9993,0,9993,RS,386
1014688_RS_386_386RS124739_30365.jpg,2690,0,2690,RS,386
1014695_RS_386_386RS124739_30400.jpg,14013,0,14013,RS,386
1014713_RS_386_386RS124739_30490.jpg,1678,50115,51793,RS,386
1014714_RS_386_386RS124739_30495.jpg,330,49029,49359,RS,386
1014723_RS_386_386RS124739_30540.jpg,725,21660,22385,RS,386
1014746_RS_386_386RS124739_30655.jpg,2748,0,2748,RS,386
1014748_RS_386_386RS124739_30665.jpg,1246,0,1246,RS,386
1014752_RS_386_386RS124739_30685.jpg,26115,0,26115,RS,386
1014754_RS_386_386RS124739_30695.jpg,19990,1431,21421,RS,386
1014755_RS_386_386RS124739_30700.jpg,1129,0,1129,RS,386
1014785_RS_386_386RS124739_30851.jpg,1719,5650,7369,RS,386
1014817_RS_386_386RS124739_31010.jpg,7975,1,7976,RS,386
1014840_RS_386_386RS124739_31125.jpg,24908,0,24908,RS,386
1014844_RS_386_386RS124739_31145.jpg,23197,2941,26138,RS,386
1014845_RS_386_386RS124739_31150.jpg,27747,706,28453,RS,386
1014856_RS_386_386RS124739_31205.jpg,17103,0,17103,RS,386
1014878_RS_386_386RS124739_31315.jpg,23286,9069,32355,RS,386
1014880_RS_386_386RS124739_31325.jpg,28246,0,28246,RS,386
1014888_RS_386_386RS124739_31365.jpg,18284,7344,25628,RS,386
1014896_RS_386_386RS124739_31405.jpg,27300,27,27327,RS,386
1014900_RS_386_386RS124739_31425.jpg,13735,0,13735,RS,386
1014919_RS_386_386RS124739_31520.jpg,1644,0,1644,RS,386
1025741_RS_386_386RS169832_08445.jpg,4450,189,4639,RS,386
1025768_RS_386_386RS169832_08580.jpg,16048,0,16048,RS,386
1025773_RS_386_386RS169832_08605.jpg,6912,0,6912,RS,386
1025782_RS_386_386RS169832_08650.jpg,4778,1,4779,RS,386
1025783_RS_386_386RS169832_08655.jpg,1826,713,2539,RS,386
1025786_RS_386_386RS169832_08670.jpg,12818,20,12838,RS,386
1025789_RS_386_386RS169832_08685.jpg,18784,60,18844,RS,386
1025791_RS_386_386RS169832_08695.jpg,11628,66,11694,RS,386
1025880_RS_386_386RS169832_09140.jpg,13851,0,13851,RS,386
1025891_RS_386_386RS169832_09195.jpg,10620,0,10620,RS,386
1026150_RS_386_386RS169832_10490.jpg,270,0,270,RS,386
1044259_DF_060_060BDF0050_00121.jpg,8,490,498,DF,060
1050931_DF_080_080BDF0050_00553.jpg,27148,0,27148,DF,080
1051484_DF_020_020BDF0070_01140.jpg,3513,231,3744,DF,020
1051764_DF_020_020BDF0070_01672.jpg,2605,2087,4692,DF,020
1051771_DF_020_020BDF0070_01684.jpg,543,1383,1926,DF,020
1051790_DF_020_020BDF0070_01724.jpg,468,3056,3524,DF,020
1052121_DF_020_020BDF0070_02438.jpg,9995,0,9995,DF,020
1052129_DF_020_020BDF0070_02453.jpg,369,2883,3252,DF,020
1053813_DF_020_020BDF0070_05945.jpg,1109,0,1109,DF,020
1053818_DF_020_020BDF0070_05954.jpg,42,4782,4824,DF,020
1053849_DF_020_020BDF0070_06009.jpg,3949,1553,5502,DF,020
1053909_DF_020_020BDF0070_06111.jpg,5916,0,5916,DF,020
1053954_DF_020_020BDF0070_06194.jpg,2030,2754,4784,DF,020
1053957_DF_020_020BDF0070_06199.jpg,3666,1854,5520,DF,020
1054908_DF_020_020BDF0070_07965.jpg,3479,0,3479,DF,020
1055058_DF_020_020BDF0070_08244.jpg,1067,2218,3285,DF,020
1055614_DF_020_020BDF0070_09283.jpg,93,638,731,DF,020
1055711_DF_020_020BDF0070_09455.jpg,946,152,1098,DF,020
1055970_DF_010_010BDF0010_00128.jpg,2196,1537,3733,DF,010
1067835_DF_010_010BDF0018_03802.jpg,1795,949,2744,DF,010
1068381_DF_010_010BDF0018_04986.jpg,49,2092,2141,DF,010
1068440_DF_010_010BDF0018_05096.jpg,603,1118,1721,DF,010
1074973_DF_251_251BDF0530_00800.jpg,2394,6,2400,DF,251
1075571_DF_251_251BDF0530_01915.jpg,9783,0,9783,DF,251
1075978_DF_251_251BDF0530_02656.jpg,17724,0,17724,DF,251
1076685_DF_251_251BDF0530_03978.jpg,8036,0,8036,DF,251
1076757_DF_251_251BDF0530_04111.jpg,12364,0,12364,DF,251
1076758_DF_251_251BDF0530_04113.jpg,1250,0,1250,DF,251
1077212_DF_251_251BDF0530_04962.jpg,1629,0,1629,DF,251
1081507_DF_080_080BDF0070_00328.jpg,12895,0,12895,DF,080
1081522_DF_080_080BDF0070_00358.jpg,8760,0,8760,DF,080
1081566_DF_080_080BDF0070_00437.jpg,8653,0,8653,DF,080
1081591_DF_080_080BDF0070_00482.jpg,6416,3538,9954,DF,080
1081596_DF_080_080BDF0070_00491.jpg,6976,125,7101,DF,080
1081659_DF_080_080BDF0070_00606.jpg,7428,0,7428,DF,080
1081676_DF_080_080BDF0070_00638.jpg,18491,0,18491,DF,080
1081703_DF_080_080BDF0070_00686.jpg,21455,0,21455,DF,080
1081769_DF_080_080BDF0070_00808.jpg,2095,0,2095,DF,080
1081889_DF_080_080BDF0070_01028.jpg,18674,0,18674,DF,080
1081908_DF_080_080BDF0070_01067.jpg,10752,0,10752,DF,080
1083759_DF_080_080BDF0090_00306.jpg,3005,0,3005,DF,080
1084436_DF_080_080BDF0090_01661.jpg,11733,4028,15761,DF,080
1084476_DF_080_080BDF0090_01732.jpg,16531,0,16531,DF,080
1085430_DF_080_080BDF0090_03602.jpg,4804,0,4804,DF,080
1090172_DF_070_070BDF0050_05625.jpg,99,3540,3639,DF,070
1090283_DF_070_070BDF0050_05829.jpg,2628,0,2628,DF,070
1091634_DF_251_251BDF0490_00628.jpg,2325,0,2325,DF,251
1091694_DF_251_251BDF0490_00742.jpg,12983,0,12983,DF,251
1091702_DF_251_251BDF0490_00758.jpg,6721,0,6721,DF,251
1091705_DF_251_251BDF0490_00764.jpg,10626,0,10626,DF,251
1091716_DF_251_251BDF0490_00784.jpg,19064,0,19064,DF,251
1091722_DF_251_251BDF0490_00796.jpg,12046,0,12046,DF,251
1091743_DF_251_251BDF0490_00836.jpg,14513,0,14513,DF,251
1091746_DF_251_251BDF0490_00842.jpg,7463,0,7463,DF,251
1091747_DF_251_251BDF0490_00844.jpg,6034,0,6034,DF,251
1091750_DF_251_251BDF0490_00850.jpg,9645,0,9645,DF,251
1091755_DF_251_251BDF0490_00859.jpg,5118,0,5118,DF,251
1091775_DF_251_251BDF0490_00895.jpg,10242,0,10242,DF,251
1091782_DF_251_251BDF0490_00910.jpg,5345,0,5345,DF,251
1091787_DF_251_251BDF0490_00919.jpg,7567,0,7567,DF,251
1091820_DF_251_251BDF0490_00981.jpg,17993,0,17993,DF,251
1091835_DF_251_251BDF0490_01010.jpg,5257,0,5257,DF,251
1091838_DF_251_251BDF0490_01016.jpg,5334,0,5334,DF,251
1091863_DF_251_251BDF0490_01063.jpg,1124,0,1124,DF,251
1091871_DF_251_251BDF0490_01078.jpg,10978,0,10978,DF,251
1091883_DF_251_251BDF0490_01101.jpg,6227,0,6227,DF,251
1091884_DF_251_251BDF0490_01104.jpg,6697,0,6697,DF,251
1091934_DF_251_251BDF0490_01198.jpg,21354,0,21354,DF,251
1091958_DF_251_251BDF0490_01243.jpg,2685,0,2685,DF,251
1091964_DF_251_251BDF0490_01253.jpg,8477,0,8477,DF,251
1091984_DF_251_251BDF0490_01290.jpg,7400,0,7400,DF,251
1092031_DF_251_251BDF0490_01377.jpg,8837,0,8837,DF,251
1092032_DF_251_251BDF0490_01379.jpg,6277,0,6277,DF,251
1092063_DF_251_251BDF0490_01436.jpg,19185,0,19185,DF,251
1092073_DF_251_251BDF0490_01454.jpg,9641,0,9641,DF,251
1092110_DF_251_251BDF0490_01520.jpg,2081,0,2081,DF,251
1092727_DF_251_251BDF0052_00466.jpg,26758,0,26758,DF,251
1092742_DF_251_251BDF0052_00492.jpg,19440,0,19440,DF,251
1092754_DF_251_251BDF0052_00513.jpg,25210,0,25210,DF,251
1092755_DF_251_251BDF0052_00515.jpg,21322,0,21322,DF,251
1092756_DF_251_251BDF0052_00516.jpg,19659,0,19659,DF,251
1092763_DF_251_251BDF0052_00527.jpg,44731,0,44731,DF,251
1092774_DF_251_251BDF0052_00546.jpg,2328,0,2328,DF,251
1092793_DF_251_251BDF0052_00580.jpg,51867,0,51867,DF,251
1092798_DF_251_251BDF0052_00588.jpg,12426,0,12426,DF,251
1092805_DF_251_251BDF0052_00600.jpg,31045,0,31045,DF,251
1092807_DF_251_251BDF0052_00604.jpg,21025,0,21025,DF,251
1092826_DF_251_251BDF0052_00638.jpg,47402,0,47402,DF,251
1092827_DF_251_251BDF0052_00639.jpg,26389,5,26394,DF,251
1092840_DF_251_251BDF0052_00662.jpg,45680,0,45680,DF,251
1092841_DF_251_251BDF0052_00663.jpg,46717,0,46717,DF,251
1092842_DF_251_251BDF0052_00665.jpg,45626,0,45626,DF,251
1092898_DF_251_251BDF0052_00764.jpg,140,766,906,DF,251
1092939_DF_251_251BDF0052_00836.jpg,34552,4474,39026,DF,251
1092941_DF_251_251BDF0052_00839.jpg,17499,0,17499,DF,251
1092979_DF_251_251BDF0052_00907.jpg,33926,0,33926,DF,251
1093083_DF_251_251BDF0052_01091.jpg,32551,0,32551,DF,251
1093339_DF_251_251BDF0052_01599.jpg,16418,0,16418,DF,251
1093729_DF_251_251BDF0052_02261.jpg,1154,0,1154,DF,251
1093882_DF_251_251BDF0052_02538.jpg,14667,0,14667,DF,251
1094290_DF_251_251BDF0052_03295.jpg,2071,0,2071,DF,251
1094535_DF_251_251BDF0052_03747.jpg,1939,0,1939,DF,251
1094910_DF_251_251BDF0052_04492.jpg,26131,0,26131,DF,251
1096867_DF_070_070BDF0010_03482.jpg,3381,0,3381,DF,070
765440_ES_259_259ES000000_01300.jpg,1856,0,1856,ES,259
766085_ES_259_259ES000000_04525.jpg,94,6431,6525,ES,259
774081_ES_259_259ES000000_44505.jpg,29,225,254,ES,259
820315_ES_259_259ES000000_03060.jpg,303,1593,1896,ES,259
883248_RS_290_290RS150131_16970.jpg,0,33531,33531,RS,290
883254_RS_290_290RS150131_17000.jpg,16,68838,68854,RS,290
884193_RS_290_290RS150131_21695.jpg,4,19757,19761,RS,290
915962_RS_290_290RS294095_13260.jpg,3511,0,3511,RS,290
915963_RS_290_290RS294095_13265.jpg,1736,0,1736,RS,290
915967_RS_290_290RS294095_13285.jpg,3148,0,3148,RS,290
916025_RS_290_290RS294095_13575.jpg,4888,0,4888,RS,290
916110_RS_290_290RS294095_14000.jpg,2611,2243,4854,RS,290
916437_RS_290_290RS294095_15635.jpg,4530,0,4530,RS,290
916654_RS_290_290RS294095_16720.jpg,8674,0,8674,RS,290
916656_RS_290_290RS294095_16730.jpg,10233,0,10233,RS,290
916874_RS_290_290RS294095_17821.jpg,3585,7573,11158,RS,290
916887_RS_290_290RS294095_17885.jpg,2110,6205,8315,RS,290
916893_RS_290_290RS294095_17916.jpg,106,6525,6631,RS,290
916930_RS_290_290RS294095_18100.jpg,1742,0,1742,RS,290
917033_RS_290_290RS294095_18615.jpg,722,0,722,RS,290
917086_RS_290_290RS294095_18880.jpg,5605,0,5605,RS,290
917194_RS_290_290RS294095_19420.jpg,3776,2703,6479,RS,290
917209_RS_290_290RS294095_19495.jpg,8920,0,8920,RS,290
917210_RS_290_290RS294095_19500.jpg,12798,0,12798,RS,290
917214_RS_290_290RS294095_19520.jpg,21255,1,21256,RS,290
917218_RS_290_290RS294095_19540.jpg,16879,0,16879,RS,290
917229_RS_290_290RS294095_19595.jpg,9180,0,9180,RS,290
917242_RS_290_290RS294095_19660.jpg,12704,0,12704,RS,290
917258_RS_290_290RS294095_19740.jpg,13137,0,13137,RS,290
917320_RS_290_290RS294095_20050.jpg,7587,0,7587,RS,290
917338_RS_290_290RS294095_20140.jpg,7047,0,7047,RS,290
917395_RS_290_290RS294095_20425.jpg,13670,1556,15226,RS,290
917396_RS_290_290RS294095_20430.jpg,14690,5417,20107,RS,290
917398_RS_290_290RS294095_20441.jpg,18873,0,18873,RS,290
917400_RS_290_290RS294095_20451.jpg,20263,0,20263,RS,290
917401_RS_290_290RS294095_20455.jpg,20849,0,20849,RS,290
917468_RS_290_290RS294095_20790.jpg,5305,944,6249,RS,290
917469_RS_290_290RS294095_20795.jpg,3176,0,3176,RS,290
917504_RS_290_290RS294095_20970.jpg,6,1850,1856,RS,290
917505_RS_290_290RS294095_20975.jpg,789,8216,9005,RS,290
917569_RS_290_290RS294095_21295.jpg,23832,0,23832,RS,290
917672_RS_290_290RS294095_21811.jpg,5889,36384,42273,RS,290
917701_RS_290_290RS294095_21955.jpg,27,22701,22728,RS,290
917959_RS_290_290RS294095_23245.jpg,12492,0,12492,RS,290
918179_RS_290_290RS294095_24346.jpg,5090,0,5090,RS,290
918232_RS_290_290RS294095_24610.jpg,8480,190,8670,RS,290
918233_RS_290_290RS294095_24615.jpg,8933,0,8933,RS,290
918531_RS_290_290RS294095_26106.jpg,2472,0,2472,RS,290
918905_RS_290_290RS294095_27975.jpg,2914,0,2914,RS,290
918995_RS_290_290RS294095_28425.jpg,9918,0,9918,RS,290
919073_RS_290_290RS294095_28815.jpg,2702,0,2702,RS,290
919127_RS_290_290RS294095_29085.jpg,2534,0,2534,RS,290
919155_RS_290_290RS294095_29225.jpg,9464,0,9464,RS,290
919167_RS_290_290RS294095_29285.jpg,14078,0,14078,RS,290
919242_RS_290_290RS294095_29660.jpg,13268,0,13268,RS,290
919243_RS_290_290RS294095_29665.jpg,12827,0,12827,RS,290
919267_RS_290_290RS294095_29785.jpg,6388,0,6388,RS,290
919541_RS_290_290RS294095_31155.jpg,7304,0,7304,RS,290
919548_RS_290_290RS294095_31191.jpg,32918,0,32918,RS,290
919554_RS_290_290RS294095_31220.jpg,6806,0,6806,RS,290
919629_RS_290_290RS294095_31595.jpg,12926,0,12926,RS,290
919752_RS_290_290RS294095_32210.jpg,7935,0,7935,RS,290
919790_RS_290_290RS294095_32400.jpg,10432,0,10432,RS,290
919804_RS_290_290RS294095_32470.jpg,9065,0,9065,RS,290
941500_RS_290_290RS070691_00406.jpg,0,1320,1320,RS,290
941573_RS_290_290RS070691_00770.jpg,0,65075,65075,RS,290
941594_RS_290_290RS070691_00875.jpg,0,67165,67165,RS,290
941605_RS_290_290RS070691_00931.jpg,8,31478,31486,RS,290
941633_RS_290_290RS070691_01071.jpg,10,3425,3435,RS,290
941911_RS_290_290RS070691_02460.jpg,0,7256,7256,RS,290
992866_RS_386_386RS191729_01095.jpg,9637,5018,14655,RS,386
994092_RS_386_386RS191729_07225.jpg,27632,0,27632,RS,386
994468_RS_386_386RS191729_09105.jpg,679,1488,2167,RS,386
994470_RS_386_386RS191729_09115.jpg,10102,0,10102,RS,386
994488_RS_386_386RS191729_09205.jpg,15372,1128,16500,RS,386
994526_RS_386_386RS191729_09396.jpg,16872,4417,21289,RS,386
994580_RS_386_386RS191729_09666.jpg,33052,840,33892,RS,386
994581_RS_386_386RS191729_09670.jpg,16990,5188,22178,RS,386
994587_RS_386_386RS191729_09700.jpg,30392,0,30392,RS,386
994589_RS_386_386RS191729_09710.jpg,22327,1237,23564,RS,386
994600_RS_386_386RS191729_09765.jpg,25974,0,25974,RS,386
1007599_RS_386_386RS289112_28920.jpg,593,0,593,RS,386
1007600_RS_386_386RS289112_28925.jpg,1854,0,1854,RS,386
1007608_RS_386_386RS289112_28966.jpg,20606,0,20606,RS,386
1008560_RS_386_386RS289112_33725.jpg,16367,0,16367,RS,386
1014583_RS_386_386RS124739_29840.jpg,7923,0,7923,RS,386
1014585_RS_386_386RS124739_29850.jpg,5656,1087,6743,RS,386
1014586_RS_386_386RS124739_29855.jpg,22462,0,22462,RS,386
1014587_RS_386_386RS124739_29860.jpg,27323,0,27323,RS,386
1014603_RS_386_386RS124739_29940.jpg,5112,0,5112,RS,386
1014604_RS_386_386RS124739_29945.jpg,2573,0,2573,RS,386
1014610_RS_386_386RS124739_29975.jpg,2492,0,2492,RS,386
1014611_RS_386_386RS124739_29980.jpg,4505,0,4505,RS,386
1014613_RS_386_386RS124739_29990.jpg,9954,0,9954,RS,386
1014615_RS_386_386RS124739_30000.jpg,1229,0,1229,RS,386
1014617_RS_386_386RS124739_30010.jpg,6594,582,7176,RS,386
1014618_RS_386_386RS124739_30015.jpg,5541,0,5541,RS,386
1014619_RS_386_386RS124739_30020.jpg,9201,1561,10762,RS,386
1014620_RS_386_386RS124739_30026.jpg,5414,0,5414,RS,386
1014621_RS_386_386RS124739_30030.jpg,4468,0,4468,RS,386
1014622_RS_386_386RS124739_30035.jpg,4596,0,4596,RS,386
1014626_RS_386_386RS124739_30055.jpg,1404,0,1404,RS,386
1014627_RS_386_386RS124739_30061.jpg,13179,0,13179,RS,386
1014630_RS_386_386RS124739_30075.jpg,19917,2324,22241,RS,386
1014631_RS_386_386RS124739_30080.jpg,15131,1550,16681,RS,386
1014632_RS_386_386RS124739_30085.jpg,8703,0,8703,RS,386
1014635_RS_386_386RS124739_30100.jpg,26209,0,26209,RS,386
1014636_RS_386_386RS124739_30105.jpg,27348,0,27348,RS,386
1014637_RS_386_386RS124739_30110.jpg,2087,0,2087,RS,386
1014638_RS_386_386RS124739_30115.jpg,6435,0,6435,RS,386
1014639_RS_386_386RS124739_30121.jpg,24716,3000,27716,RS,386
1014640_RS_386_386RS124739_30127.jpg,1515,606,2121,RS,386
1014641_RS_386_386RS124739_30130.jpg,16877,728,17605,RS,386
1014642_RS_386_386RS124739_30135.jpg,31602,0,31602,RS,386
1014643_RS_386_386RS124739_30140.jpg,434,0,434,RS,386
1014644_RS_386_386RS124739_30145.jpg,16586,0,16586,RS,386
1014645_RS_386_386RS124739_30150.jpg,10404,0,10404,RS,386
1014648_RS_386_386RS124739_30165.jpg,8344,11,8355,RS,386
1014649_RS_386_386RS124739_30170.jpg,6710,17370,24080,RS,386
1014651_RS_386_386RS124739_30180.jpg,1398,0,1398,RS,386
1014652_RS_386_386RS124739_30185.jpg,6958,0,6958,RS,386
1014654_RS_386_386RS124739_30195.jpg,14759,0,14759,RS,386
1014655_RS_386_386RS124739_30200.jpg,19288,0,19288,RS,386
1014658_RS_386_386RS124739_30216.jpg,2355,1329,3684,RS,386
1014659_RS_386_386RS124739_30220.jpg,10481,2469,12950,RS,386
1014660_RS_386_386RS124739_30225.jpg,3528,0,3528,RS,386
1014661_RS_386_386RS124739_30230.jpg,15289,0,15289,RS,386
1014663_RS_386_386RS124739_30240.jpg,5534,0,5534,RS,386
1014664_RS_386_386RS124739_30246.jpg,2768,0,2768,RS,386
1014665_RS_386_386RS124739_30250.jpg,2065,0,2065,RS,386
1014668_RS_386_386RS124739_30265.jpg,3900,0,3900,RS,386
1014669_RS_386_386RS124739_30271.jpg,20968,0,20968,RS,386
1014670_RS_386_386RS124739_30275.jpg,12986,0,12986,RS,386
1014671_RS_386_386RS124739_30280.jpg,10705,0,10705,RS,386
1014672_RS_386_386RS124739_30285.jpg,536,0,536,RS,386
1014673_RS_386_386RS124739_30290.jpg,110,624,734,RS,386
1014675_RS_386_386RS124739_30300.jpg,40751,0,40751,RS,386
1014676_RS_386_386RS124739_30305.jpg,37523,0,37523,RS,386
1014677_RS_386_386RS124739_30310.jpg,47705,0,47705,RS,386
1014678_RS_386_386RS124739_30315.jpg,33335,0,33335,RS,386
1014679_RS_386_386RS124739_30321.jpg,29252,0,29252,RS,386
1014680_RS_386_386RS124739_30325.jpg,45914,0,45914,RS,386
1014681_RS_386_386RS124739_30330.jpg,21481,2388,23869,RS,386
1014683_RS_386_386RS124739_30340.jpg,18068,0,18068,RS,386
1014684_RS_386_386RS124739_30345.jpg,12378,0,12378,RS,386
1014685_RS_386_386RS124739_30350.jpg,12313,0,12313,RS,386
1014686_RS_386_386RS124739_30355.jpg,23483,0,23483,RS,386
1014687_RS_386_386RS124739_30360.jpg,20106,0,20106,RS,386
1014689_RS_386_386RS124739_30371.jpg,11062,0,11062,RS,386
1014691_RS_386_386RS124739_30380.jpg,4306,438,4744,RS,386
1014692_RS_386_386RS124739_30385.jpg,6787,0,6787,RS,386
1014693_RS_386_386RS124739_30390.jpg,13034,0,13034,RS,386
1014696_RS_386_386RS124739_30405.jpg,7909,0,7909,RS,386
1014697_RS_386_386RS124739_30410.jpg,12051,0,12051,RS,386
1014698_RS_386_386RS124739_30415.jpg,3825,0,3825,RS,386
1014702_RS_386_386RS124739_30435.jpg,10081,0,10081,RS,386
1014703_RS_386_386RS124739_30440.jpg,14450,0,14450,RS,386
1014704_RS_386_386RS124739_30445.jpg,34801,0,34801,RS,386
1014705_RS_386_386RS124739_30450.jpg,58241,0,58241,RS,386
1014706_RS_386_386RS124739_30455.jpg,9536,0,9536,RS,386
1014707_RS_386_386RS124739_30460.jpg,15527,0,15527,RS,386
1014708_RS_386_386RS124739_30465.jpg,37985,0,37985,RS,386
1014709_RS_386_386RS124739_30470.jpg,5108,0,5108,RS,386
1014710_RS_386_386RS124739_30475.jpg,4108,0,4108,RS,386
1014711_RS_386_386RS124739_30480.jpg,2473,0,2473,RS,386
1014712_RS_386_386RS124739_30485.jpg,9452,32209,41661,RS,386
1014716_RS_386_386RS124739_30505.jpg,135,5322,5457,RS,386
1014721_RS_386_386RS124739_30530.jpg,21,6301,6322,RS,386
1014722_RS_386_386RS124739_30536.jpg,136,12910,13046,RS,386
1014724_RS_386_386RS124739_30545.jpg,195,1067,1262,RS,386
1014725_RS_386_386RS124739_30550.jpg,17630,0,17630,RS,386
1014726_RS_386_386RS124739_30555.jpg,48352,0,48352,RS,386
1014727_RS_386_386RS124739_30560.jpg,39888,0,39888,RS,386
1014728_RS_386_386RS124739_30565.jpg,2635,0,2635,RS,386
1014729_RS_386_386RS124739_30570.jpg,6822,3821,10643,RS,386
1014730_RS_386_386RS124739_30575.jpg,183,14912,15095,RS,386
1014737_RS_386_386RS124739_30610.jpg,15618,0,15618,RS,386
1014745_RS_386_386RS124739_30651.jpg,2468,0,2468,RS,386
1014747_RS_386_386RS124739_30660.jpg,1966,0,1966,RS,386
1014749_RS_386_386RS124739_30670.jpg,24627,0,24627,RS,386
1014750_RS_386_386RS124739_30675.jpg,12473,0,12473,RS,386
1014751_RS_386_386RS124739_30680.jpg,10687,0,10687,RS,386
1014753_RS_386_386RS124739_30690.jpg,31022,0,31022,RS,386
1014756_RS_386_386RS124739_30705.jpg,1782,0,1782,RS,386
1014757_RS_386_386RS124739_30710.jpg,3914,0,3914,RS,386
1014758_RS_386_386RS124739_30715.jpg,27273,0,27273,RS,386
1014759_RS_386_386RS124739_30720.jpg,3571,0,3571,RS,386
1014760_RS_386_386RS124739_30725.jpg,785,0,785,RS,386
1014761_RS_386_386RS124739_30730.jpg,6598,0,6598,RS,386
1014762_RS_386_386RS124739_30735.jpg,15491,0,15491,RS,386
1014765_RS_386_386RS124739_30750.jpg,30161,745,30906,RS,386
1014766_RS_386_386RS124739_30755.jpg,2265,0,2265,RS,386
1014767_RS_386_386RS124739_30760.jpg,1022,3713,4735,RS,386
1014768_RS_386_386RS124739_30765.jpg,1070,9962,11032,RS,386
1014776_RS_386_386RS124739_30806.jpg,2126,22882,25008,RS,386
1014777_RS_386_386RS124739_30811.jpg,4995,382,5377,RS,386
1014778_RS_386_386RS124739_30816.jpg,1838,0,1838,RS,386
1014780_RS_386_386RS124739_30826.jpg,16600,7409,24009,RS,386
1014782_RS_386_386RS124739_30835.jpg,6993,0,6993,RS,386
1014783_RS_386_386RS124739_30840.jpg,28099,0,28099,RS,386
1014784_RS_386_386RS124739_30845.jpg,15754,0,15754,RS,386
1014786_RS_386_386RS124739_30856.jpg,12098,34061,46159,RS,386
1014787_RS_386_386RS124739_30860.jpg,14499,59756,74255,RS,386
1014788_RS_386_386RS124739_30865.jpg,10072,1704,11776,RS,386
1014789_RS_386_386RS124739_30870.jpg,20752,1619,22371,RS,386
1014790_RS_386_386RS124739_30875.jpg,8403,3774,12177,RS,386
1014791_RS_386_386RS124739_30880.jpg,5066,6015,11081,RS,386
1014792_RS_386_386RS124739_30885.jpg,5357,24293,29650,RS,386
1014793_RS_386_386RS124739_30890.jpg,10196,33485,43681,RS,386
1014794_RS_386_386RS124739_30895.jpg,6852,0,6852,RS,386
1014798_RS_386_386RS124739_30915.jpg,3390,627,4017,RS,386
1014799_RS_386_386RS124739_30920.jpg,13857,752,14609,RS,386
1014801_RS_386_386RS124739_30930.jpg,11992,3926,15918,RS,386
1014802_RS_386_386RS124739_30935.jpg,22635,2564,25199,RS,386
1014803_RS_386_386RS124739_30940.jpg,49401,8290,57691,RS,386
1014804_RS_386_386RS124739_30945.jpg,64038,0,64038,RS,386
1014805_RS_386_386RS124739_30950.jpg,49412,0,49412,RS,386
1014806_RS_386_386RS124739_30955.jpg,5461,0,5461,RS,386
1014809_RS_386_386RS124739_30970.jpg,10741,0,10741,RS,386
1014810_RS_386_386RS124739_30975.jpg,4790,0,4790,RS,386
1014816_RS_386_386RS124739_31005.jpg,8114,417,8531,RS,386
1014818_RS_386_386RS124739_31015.jpg,4619,0,4619,RS,386
1014822_RS_386_386RS124739_31035.jpg,5236,0,5236,RS,386
1014823_RS_386_386RS124739_31040.jpg,18537,0,18537,RS,386
1014824_RS_386_386RS124739_31045.jpg,44268,0,44268,RS,386
1014826_RS_386_386RS124739_31055.jpg,12825,0,12825,RS,386
1014827_RS_386_386RS124739_31060.jpg,13649,0,13649,RS,386
1014830_RS_386_386RS124739_31075.jpg,4471,0,4471,RS,386
1014831_RS_386_386RS124739_31080.jpg,25745,0,25745,RS,386
1014832_RS_386_386RS124739_31085.jpg,18839,0,18839,RS,386
1014841_RS_386_386RS124739_31130.jpg,36818,0,36818,RS,386
1014843_RS_386_386RS124739_31140.jpg,31097,1434,32531,RS,386
1014846_RS_386_386RS124739_31155.jpg,55492,0,55492,RS,386
1014847_RS_386_386RS124739_31160.jpg,30868,0,30868,RS,386
1014848_RS_386_386RS124739_31165.jpg,13570,0,13570,RS,386
1014849_RS_386_386RS124739_31170.jpg,25433,0,25433,RS,386
1014850_RS_386_386RS124739_31175.jpg,4843,0,4843,RS,386
1014854_RS_386_386RS124739_31196.jpg,3393,0,3393,RS,386
1014855_RS_386_386RS124739_31201.jpg,5811,1053,6864,RS,386
1014857_RS_386_386RS124739_31210.jpg,16944,0,16944,RS,386
1014858_RS_386_386RS124739_31215.jpg,47632,0,47632,RS,386
1014859_RS_386_386RS124739_31220.jpg,33797,0,33797,RS,386
1014861_RS_386_386RS124739_31231.jpg,30333,0,30333,RS,386
1014862_RS_386_386RS124739_31235.jpg,35234,0,35234,RS,386
1014864_RS_386_386RS124739_31245.jpg,22240,0,22240,RS,386
1014865_RS_386_386RS124739_31250.jpg,19300,0,19300,RS,386
1014866_RS_386_386RS124739_31255.jpg,29237,0,29237,RS,386
1014868_RS_386_386RS124739_31265.jpg,1450,0,1450,RS,386
1014870_RS_386_386RS124739_31275.jpg,7631,0,7631,RS,386
1014871_RS_386_386RS124739_31280.jpg,14470,0,14470,RS,386
1014872_RS_386_386RS124739_31285.jpg,13588,0,13588,RS,386
1014873_RS_386_386RS124739_31290.jpg,7529,0,7529,RS,386
1014874_RS_386_386RS124739_31295.jpg,9688,217,9905,RS,386
1014875_RS_386_386RS124739_31300.jpg,10468,0,10468,RS,386
1014877_RS_386_386RS124739_31310.jpg,4270,32250,36520,RS,386
1014879_RS_386_386RS124739_31320.jpg,40764,0,40764,RS,386
1014881_RS_386_386RS124739_31330.jpg,19970,0,19970,RS,386
1014882_RS_386_386RS124739_31335.jpg,26039,0,26039,RS,386
1014883_RS_386_386RS124739_31341.jpg,8246,0,8246,RS,386
1014886_RS_386_386RS124739_31355.jpg,3141,0,3141,RS,386
1014887_RS_386_386RS124739_31360.jpg,18840,0,18840,RS,386
1014889_RS_386_386RS124739_31370.jpg,50943,10725,61668,RS,386
1014890_RS_386_386RS124739_31375.jpg,18320,0,18320,RS,386
1014891_RS_386_386RS124739_31381.jpg,18789,0,18789,RS,386
1014892_RS_386_386RS124739_31385.jpg,23516,0,23516,RS,386
1014893_RS_386_386RS124739_31390.jpg,40691,0,40691,RS,386
1014894_RS_386_386RS124739_31395.jpg,46845,0,46845,RS,386
1014897_RS_386_386RS124739_31410.jpg,38537,0,38537,RS,386
1014898_RS_386_386RS124739_31415.jpg,29396,0,29396,RS,386
1014899_RS_386_386RS124739_31420.jpg,23900,0,23900,RS,386
1014901_RS_386_386RS124739_31430.jpg,6069,0,6069,RS,386
1014902_RS_386_386RS124739_31436.jpg,9486,0,9486,RS,386
1014903_RS_386_386RS124739_31441.jpg,3615,0,3615,RS,386
1014905_RS_386_386RS124739_31451.jpg,8621,20523,29144,RS,386
1014906_RS_386_386RS124739_31456.jpg,21241,0,21241,RS,386
1014907_RS_386_386RS124739_31460.jpg,17229,0,17229,RS,386
1014908_RS_386_386RS124739_31465.jpg,14906,0,14906,RS,386
1014909_RS_386_386RS124739_31470.jpg,2090,0,2090,RS,386
1014910_RS_386_386RS124739_31475.jpg,3704,0,3704,RS,386
1014911_RS_386_386RS124739_31480.jpg,1758,0,1758,RS,386
1014912_RS_386_386RS124739_31485.jpg,1670,0,1670,RS,386
1014913_RS_386_386RS124739_31490.jpg,6310,15983,22293,RS,386
1014914_RS_386_386RS124739_31495.jpg,2372,23507,25879,RS,386
1014915_RS_386_386RS124739_31500.jpg,154,3374,3528,RS,386
1014916_RS_386_386RS124739_31505.jpg,4122,0,4122,RS,386
1014917_RS_386_386RS124739_31510.jpg,2492,0,2492,RS,386
1014918_RS_386_386RS124739_31515.jpg,5373,0,5373,RS,386
1025742_RS_386_386RS169832_08450.jpg,23783,0,23783,RS,386
1025743_RS_386_386RS169832_08455.jpg,3042,0,3042,RS,386
1025762_RS_386_386RS169832_08550.jpg,4567,0,4567,RS,386
1025763_RS_386_386RS169832_08555.jpg,25281,0,25281,RS,386
1025766_RS_386_386RS169832_08570.jpg,1594,0,1594,RS,386
1025767_RS_386_386RS169832_08575.jpg,15954,0,15954,RS,386
1025769_RS_386_386RS169832_08585.jpg,9856,0,9856,RS,386
1025770_RS_386_386RS169832_08590.jpg,15084,0,15084,RS,386
1025771_RS_386_386RS169832_08595.jpg,11187,0,11187,RS,386
1025776_RS_386_386RS169832_08621.jpg,10002,0,10002,RS,386
1025777_RS_386_386RS169832_08625.jpg,14106,0,14106,RS,386
1025778_RS_386_386RS169832_08630.jpg,6185,59421,65606,RS,386
1025779_RS_386_386RS169832_08635.jpg,6687,0,6687,RS,386
1025780_RS_386_386RS169832_08640.jpg,13163,0,13163,RS,386
1025781_RS_386_386RS169832_08645.jpg,11159,0,11159,RS,386
1025784_RS_386_386RS169832_08660.jpg,2126,0,2126,RS,386
1025785_RS_386_386RS169832_08665.jpg,13842,0,13842,RS,386
1025787_RS_386_386RS169832_08675.jpg,20231,0,20231,RS,386
1025788_RS_386_386RS169832_08680.jpg,6161,0,6161,RS,386
1025790_RS_386_386RS169832_08691.jpg,15008,2872,17880,RS,386
1025792_RS_386_386RS169832_08700.jpg,10255,1204,11459,RS,386
1025793_RS_386_386RS169832_08705.jpg,3608,0,3608,RS,386
1025794_RS_386_386RS169832_08710.jpg,8011,962,8973,RS,386
1025795_RS_386_386RS169832_08715.jpg,10519,1308,11827,RS,386
1025796_RS_386_386RS169832_08721.jpg,4839,1709,6548,RS,386
1025797_RS_386_386RS169832_08725.jpg,12771,2062,14833,RS,386
1025798_RS_386_386RS169832_08730.jpg,6373,0,6373,RS,386
1025799_RS_386_386RS169832_08735.jpg,19785,1254,21039,RS,386
1025800_RS_386_386RS169832_08740.jpg,40340,2752,43092,RS,386
1025801_RS_386_386RS169832_08745.jpg,2932,2181,5113,RS,386
1025810_RS_386_386RS169832_08790.jpg,2788,0,2788,RS,386
1025812_RS_386_386RS169832_08800.jpg,6870,1019,7889,RS,386
1025813_RS_386_386RS169832_08805.jpg,3155,0,3155,RS,386
1025814_RS_386_386RS169832_08810.jpg,2350,0,2350,RS,386
1025815_RS_386_386RS169832_08815.jpg,108,126,234,RS,386
1025816_RS_386_386RS169832_08821.jpg,177,800,977,RS,386
1025817_RS_386_386RS169832_08825.jpg,11960,2155,14115,RS,386
1025818_RS_386_386RS169832_08831.jpg,11034,415,11449,RS,386
1025819_RS_386_386RS169832_08835.jpg,4,412,416,RS,386
1025820_RS_386_386RS169832_08840.jpg,509,698,1207,RS,386
1025821_RS_386_386RS169832_08845.jpg,3479,9759,13238,RS,386
1025866_RS_386_386RS169832_09070.jpg,2183,0,2183,RS,386
1025873_RS_386_386RS169832_09105.jpg,27749,0,27749,RS,386
1025879_RS_386_386RS169832_09135.jpg,13812,0,13812,RS,386
1025884_RS_386_386RS169832_09160.jpg,19988,0,19988,RS,386
1025885_RS_386_386RS169832_09165.jpg,11041,0,11041,RS,386
1025898_RS_386_386RS169832_09230.jpg,3531,0,3531,RS,386
1025899_RS_386_386RS169832_09235.jpg,15894,0,15894,RS,386
1025900_RS_386_386RS169832_09240.jpg,6125,0,6125,RS,386
1025903_RS_386_386RS169832_09255.jpg,15934,0,15934,RS,386
1025905_RS_386_386RS169832_09265.jpg,13864,0,13864,RS,386
1025906_RS_386_386RS169832_09270.jpg,9065,0,9065,RS,386
1025907_RS_386_386RS169832_09276.jpg,5190,0,5190,RS,386
1025908_RS_386_386RS169832_09280.jpg,6104,0,6104,RS,386
1025911_RS_386_386RS169832_09295.jpg,8197,0,8197,RS,386
1025912_RS_386_386RS169832_09301.jpg,9856,0,9856,RS,386
1025914_RS_386_386RS169832_09310.jpg,13316,0,13316,RS,386
1025919_RS_386_386RS169832_09335.jpg,2658,0,2658,RS,386
1025920_RS_386_386RS169832_09340.jpg,5258,0,5258,RS,386
1025921_RS_386_386RS169832_09345.jpg,2635,0,2635,RS,386
1025923_RS_386_386RS169832_09355.jpg,7943,0,7943,RS,386
1025924_RS_386_386RS169832_09360.jpg,9658,0,9658,RS,386
1025932_RS_386_386RS169832_09400.jpg,3225,0,3225,RS,386
1025934_RS_386_386RS169832_09410.jpg,4786,0,4786,RS,386
1026108_RS_386_386RS169832_10280.jpg,3,394,397,RS,386
1026151_RS_386_386RS169832_10495.jpg,1204,3918,5122,RS,386
1026154_RS_386_386RS169832_10510.jpg,2470,0,2470,RS,386
1026155_RS_386_386RS169832_10515.jpg,3264,0,3264,RS,386
1026261_RS_386_386RS169832_11045.jpg,3667,0,3667,RS,386
1026265_RS_386_386RS169832_11065.jpg,19,3122,3141,RS,386
1044260_DF_060_060BDF0050_00122.jpg,0,1076,1076,DF,060
1045837_DF_060_060BDF0030_00575.jpg,0,1087,1087,DF,060
1045838_DF_060_060BDF0030_00577.jpg,0,2857,2857,DF,060
1045857_DF_060_060BDF0030_00613.jpg,3,768,771,DF,060
1046386_DF_060_060BDF0030_01575.jpg,0,1493,1493,DF,060
1046388_DF_060_060BDF0030_01578.jpg,8,15869,15877,DF,060
1046852_DF_060_060BDF0030_02444.jpg,6922,0,6922,DF,060
1047005_DF_060_060BDF0030_02725.jpg,0,3265,3265,DF,060
1047047_DF_060_060BDF0030_02806.jpg,0,1424,1424,DF,060
1047314_DF_060_060BDF0030_03296.jpg,0,15666,15666,DF,060
1048538_DF_060_060BDF0012_01656.jpg,0,1283,1283,DF,060
1048685_DF_060_060BDF0010_00160.jpg,0,15259,15259,DF,060
1050564_DF_080_080BDF0050_1_00368.jpg,1448,10191,11639,DF,080
1051464_DF_020_020BDF0070_01099.jpg,4257,3957,8214,DF,020
1051465_DF_020_020BDF0070_01101.jpg,1052,3380,4432,DF,020
1051753_DF_020_020BDF0070_01649.jpg,16,2625,2641,DF,020
1051762_DF_020_020BDF0070_01668.jpg,13191,0,13191,DF,020
1051763_DF_020_020BDF0070_01670.jpg,7911,328,8239,DF,020
1051767_DF_020_020BDF0070_01678.jpg,5,5281,5286,DF,020
1051768_DF_020_020BDF0070_01679.jpg,1,5063,5064,DF,020
1051772_DF_020_020BDF0070_01686.jpg,4,995,999,DF,020
1051789_DF_020_020BDF0070_01722.jpg,32,1366,1398,DF,020
1051791_DF_020_020BDF0070_01726.jpg,0,1635,1635,DF,020
1052123_DF_020_020BDF0070_02442.jpg,3663,0,3663,DF,020
1052125_DF_020_020BDF0070_02446.jpg,11,5141,5152,DF,020
1053801_DF_020_020BDF0070_05925.jpg,20595,0,20595,DF,020
1053802_DF_020_020BDF0070_05927.jpg,15036,997,16033,DF,020
1053803_DF_020_020BDF0070_05929.jpg,14856,5156,20012,DF,020
1053828_DF_020_020BDF0070_05973.jpg,40,1651,1691,DF,020
1053829_DF_020_020BDF0070_05975.jpg,87,2853,2940,DF,020
1053836_DF_020_020BDF0070_05986.jpg,0,595,595,DF,020
1053837_DF_020_020BDF0070_05988.jpg,158,1287,1445,DF,020
1053848_DF_020_020BDF0070_06007.jpg,361,2855,3216,DF,020
1053862_DF_020_020BDF0070_06032.jpg,7395,0,7395,DF,020
1053871_DF_020_020BDF0070_06046.jpg,3149,5396,8545,DF,020
1053879_DF_020_020BDF0070_06059.jpg,5410,905,6315,DF,020
1053880_DF_020_020BDF0070_06061.jpg,12178,0,12178,DF,020
1053881_DF_020_020BDF0070_06062.jpg,12984,0,12984,DF,020
1053883_DF_020_020BDF0070_06066.jpg,1727,0,1727,DF,020
1053888_DF_020_020BDF0070_06075.jpg,61,1559,1620,DF,020
1053907_DF_020_020BDF0070_06107.jpg,7377,0,7377,DF,020
1053908_DF_020_020BDF0070_06109.jpg,12507,0,12507,DF,020
1053938_DF_020_020BDF0070_06163.jpg,889,4894,5783,DF,020
1053939_DF_020_020BDF0070_06165.jpg,23,9795,9818,DF,020
1053953_DF_020_020BDF0070_06192.jpg,4,1001,1005,DF,020
1053958_DF_020_020BDF0070_06201.jpg,5667,0,5667,DF,020
1053962_DF_020_020BDF0070_06208.jpg,5,2052,2057,DF,020
1053963_DF_020_020BDF0070_06210.jpg,406,4300,4706,DF,020
1053964_DF_020_020BDF0070_06212.jpg,24917,1525,26442,DF,020
1053965_DF_020_020BDF0070_06213.jpg,25676,3470,29146,DF,020
1053991_DF_020_020BDF0070_06265.jpg,35135,7800,42935,DF,020
1053992_DF_020_020BDF0070_06266.jpg,29623,7735,37358,DF,020
1053993_DF_020_020BDF0070_06268.jpg,26362,2301,28663,DF,020
1053996_DF_020_020BDF0070_06273.jpg,17802,0,17802,DF,020
1053997_DF_020_020BDF0070_06275.jpg,16719,1623,18342,DF,020
1054891_DF_020_020BDF0070_07935.jpg,6768,0,6768,DF,020
1054896_DF_020_020BDF0070_07944.jpg,4525,0,4525,DF,020
1054897_DF_020_020BDF0070_07945.jpg,2504,0,2504,DF,020
1054926_DF_020_020BDF0070_07999.jpg,3401,0,3401,DF,020
1054927_DF_020_020BDF0070_08001.jpg,2788,0,2788,DF,020
1054928_DF_020_020BDF0070_08003.jpg,1171,0,1171,DF,020
1054936_DF_020_020BDF0070_08017.jpg,13028,1903,14931,DF,020
1054937_DF_020_020BDF0070_08018.jpg,13078,5056,18134,DF,020
1054938_DF_020_020BDF0070_08020.jpg,19945,2129,22074,DF,020
1054939_DF_020_020BDF0070_08022.jpg,9656,1053,10709,DF,020
1054941_DF_020_020BDF0070_08025.jpg,14378,0,14378,DF,020
1054962_DF_020_020BDF0070_08063.jpg,6242,1383,7625,DF,020
1054963_DF_020_020BDF0070_08065.jpg,3952,5847,9799,DF,020
1055059_DF_020_020BDF0070_08245.jpg,2,9483,9485,DF,020
1055376_DF_020_020BDF0070_08828.jpg,7698,0,7698,DF,020
1055466_DF_020_020BDF0070_09001.jpg,14,5854,5868,DF,020
1055542_DF_020_020BDF0070_09147.jpg,202,11780,11982,DF,020
1055550_DF_020_020BDF0070_09162.jpg,4998,0,4998,DF,020
1055555_DF_020_020BDF0070_09174.jpg,49,8153,8202,DF,020
1055690_DF_020_020BDF0070_09415.jpg,297,0,297,DF,020
1055762_DF_020_020BDF0070_09552.jpg,114,0,114,DF,020
1055763_DF_020_020BDF0070_09554.jpg,2037,0,2037,DF,020
1055777_DF_020_020BDF0070_09579.jpg,2513,0,2513,DF,020
1055780_DF_020_020BDF0070_09584.jpg,18340,0,18340,DF,020
1055781_DF_020_020BDF0070_09586.jpg,1902,0,1902,DF,020
1055782_DF_020_020BDF0070_09588.jpg,15275,1607,16882,DF,020
1055783_DF_020_020BDF0070_09590.jpg,5046,975,6021,DF,020
1055790_DF_020_020BDF0070_09603.jpg,358,1343,1701,DF,020
1055965_DF_010_010BDF0010_00119.jpg,3991,0,3991,DF,010
1055969_DF_010_010BDF0010_00127.jpg,7073,0,7073,DF,010
1056900_DF_010_010BDF0010_01826.jpg,0,1251,1251,DF,010
1058796_DF_010_010BDF0010_06132.jpg,0,617,617,DF,010
1058797_DF_010_010BDF0010_06134.jpg,0,994,994,DF,010
1058798_DF_010_010BDF0010_06135.jpg,0,1276,1276,DF,010
1058912_DF_010_010BDF0010_06344.jpg,0,967,967,DF,010
1058913_DF_010_010BDF0010_06346.jpg,0,2529,2529,DF,010
1058931_DF_010_010BDF0010_06381.jpg,1838,0,1838,DF,010
1059088_DF_010_010BDF0010_06677.jpg,3908,0,3908,DF,010
1061031_DF_251_251BDF0525_00530.jpg,0,659,659,DF,251
1061032_DF_251_251BDF0525_00532.jpg,0,1777,1777,DF,251
1061033_DF_251_251BDF0525_00534.jpg,0,2967,2967,DF,251
1061101_DF_251_251BDF0525_00655.jpg,0,1794,1794,DF,251
1061102_DF_251_251BDF0525_00657.jpg,0,6277,6277,DF,251
1063402_DF_080_080BDF0032_01673.jpg,3082,0,3082,DF,080
1064688_DF_080_080BDF0032_04157.jpg,2467,0,2467,DF,080
1066460_DF_010_010BDF0018_00939.jpg,0,381,381,DF,010
1066570_DF_010_010BDF0018_01156.jpg,224,899,1123,DF,010
1066571_DF_010_010BDF0018_01158.jpg,0,1609,1609,DF,010
1067606_DF_010_010BDF0018_03300.jpg,0,821,821,DF,010
1067607_DF_010_010BDF0018_03301.jpg,0,952,952,DF,010
1067608_DF_010_010BDF0018_03303.jpg,5,4054,4059,DF,010
1067754_DF_010_010BDF0018_03608.jpg,8449,0,8449,DF,010
1067841_DF_010_010BDF0018_03817.jpg,25,4656,4681,DF,010
1067844_DF_010_010BDF0018_03824.jpg,8270,0,8270,DF,010
1067847_DF_010_010BDF0018_03831.jpg,0,6792,6792,DF,010
1067848_DF_010_010BDF0018_03834.jpg,2,763,765,DF,010
1068044_DF_010_010BDF0018_04237.jpg,0,440,440,DF,010
1068045_DF_010_010BDF0018_04239.jpg,0,1418,1418,DF,010
1068089_DF_010_010BDF0018_04320.jpg,0,3156,3156,DF,010
1068104_DF_010_010BDF0018_04348.jpg,2225,0,2225,DF,010
1068310_DF_010_010BDF0018_04817.jpg,0,1913,1913,DF,010
1068350_DF_010_010BDF0018_04909.jpg,227,2256,2483,DF,010
1068373_DF_010_010BDF0018_04969.jpg,22,6171,6193,DF,010
1068382_DF_010_010BDF0018_04988.jpg,180,2873,3053,DF,010
1068447_DF_010_010BDF0018_05110.jpg,0,1299,1299,DF,010
1068448_DF_010_010BDF0018_05112.jpg,2,2212,2214,DF,010
1075250_DF_251_251BDF0530_01330.jpg,207,857,1064,DF,251
1075251_DF_251_251BDF0530_01332.jpg,2957,2518,5475,DF,251
1075536_DF_251_251BDF0530_01851.jpg,33336,0,33336,DF,251
1075537_DF_251_251BDF0530_01853.jpg,23848,0,23848,DF,251
1075538_DF_251_251BDF0530_01855.jpg,15144,0,15144,DF,251
1075539_DF_251_251BDF0530_01857.jpg,7093,0,7093,DF,251
1075545_DF_251_251BDF0530_01868.jpg,35301,0,35301,DF,251
1075546_DF_251_251BDF0530_01869.jpg,24655,0,24655,DF,251
1075547_DF_251_251BDF0530_01871.jpg,8704,0,8704,DF,251
1075576_DF_251_251BDF0530_01924.jpg,6291,0,6291,DF,251
1075577_DF_251_251BDF0530_01925.jpg,10967,0,10967,DF,251
1075584_DF_251_251BDF0530_01938.jpg,6792,0,6792,DF,251
1075585_DF_251_251BDF0530_01939.jpg,2191,0,2191,DF,251
1075612_DF_251_251BDF0530_01986.jpg,27535,0,27535,DF,251
1075613_DF_251_251BDF0530_01988.jpg,15033,0,15033,DF,251
1075617_DF_251_251BDF0530_01995.jpg,20560,3802,24362,DF,251
1075621_DF_251_251BDF0530_02002.jpg,13504,2090,15594,DF,251
1075627_DF_251_251BDF0530_02013.jpg,28524,0,28524,DF,251
1075888_DF_251_251BDF0530_02487.jpg,10030,0,10030,DF,251
1075897_DF_251_251BDF0530_02503.jpg,22230,0,22230,DF,251
1075898_DF_251_251BDF0530_02505.jpg,16273,0,16273,DF,251
1076069_DF_251_251BDF0530_02829.jpg,808,0,808,DF,251
1076073_DF_251_251BDF0530_02837.jpg,14706,0,14706,DF,251
1076074_DF_251_251BDF0530_02840.jpg,5349,0,5349,DF,251
1076329_DF_251_251BDF0530_03316.jpg,4626,0,4626,DF,251
1076330_DF_251_251BDF0530_03317.jpg,20066,0,20066,DF,251
1076331_DF_251_251BDF0530_03319.jpg,16563,0,16563,DF,251
1076333_DF_251_251BDF0530_03323.jpg,8349,0,8349,DF,251
1076435_DF_251_251BDF0530_03507.jpg,27743,0,27743,DF,251
1076436_DF_251_251BDF0530_03509.jpg,26742,0,26742,DF,251
1076437_DF_251_251BDF0530_03511.jpg,24171,0,24171,DF,251
1076438_DF_251_251BDF0530_03513.jpg,16160,0,16160,DF,251
1076487_DF_251_251BDF0530_03603.jpg,33661,0,33661,DF,251
1076488_DF_251_251BDF0530_03605.jpg,23228,0,23228,DF,251
1076608_DF_251_251BDF0530_03838.jpg,17510,0,17510,DF,251
1076632_DF_251_251BDF0530_03880.jpg,21354,0,21354,DF,251
1076633_DF_251_251BDF0530_03882.jpg,9686,0,9686,DF,251
1076638_DF_251_251BDF0530_03892.jpg,13835,0,13835,DF,251
1076639_DF_251_251BDF0530_03893.jpg,19155,0,19155,DF,251
1076640_DF_251_251BDF0530_03895.jpg,6634,0,6634,DF,251
1076641_DF_251_251BDF0530_03897.jpg,6914,0,6914,DF,251
1076683_DF_251_251BDF0530_03975.jpg,8188,0,8188,DF,251
1076684_DF_251_251BDF0530_03977.jpg,10656,0,10656,DF,251
1076695_DF_251_251BDF0530_03997.jpg,1099,0,1099,DF,251
1076696_DF_251_251BDF0530_03999.jpg,3828,0,3828,DF,251
1076756_DF_251_251BDF0530_04109.jpg,6177,0,6177,DF,251
1076888_DF_251_251BDF0530_04351.jpg,6951,0,6951,DF,251
1076999_DF_251_251BDF0530_04555.jpg,1019,0,1019,DF,251
1077140_DF_251_251BDF0530_04826.jpg,492,0,492,DF,251
1077141_DF_251_251BDF0530_04829.jpg,1564,0,1564,DF,251
1077169_DF_251_251BDF0530_04882.jpg,9050,0,9050,DF,251
1077179_DF_251_251BDF0530_04900.jpg,2077,0,2077,DF,251
1077199_DF_251_251BDF0530_04936.jpg,5470,0,5470,DF,251
1077204_DF_251_251BDF0530_04946.jpg,2866,0,2866,DF,251
1077206_DF_251_251BDF0530_04950.jpg,2499,0,2499,DF,251
1077207_DF_251_251BDF0530_04952.jpg,4205,0,4205,DF,251
1077234_DF_251_251BDF0530_05003.jpg,7520,0,7520,DF,251
1077242_DF_251_251BDF0530_05018.jpg,3958,0,3958,DF,251
1077243_DF_251_251BDF0530_05020.jpg,5729,0,5729,DF,251
1077244_DF_251_251BDF0530_05022.jpg,10372,0,10372,DF,251
1077245_DF_251_251BDF0530_05023.jpg,9409,0,9409,DF,251
1077246_DF_251_251BDF0530_05025.jpg,23108,0,23108,DF,251
1077247_DF_251_251BDF0530_05027.jpg,24439,0,24439,DF,251
1077248_DF_251_251BDF0530_05029.jpg,17352,0,17352,DF,251
1077249_DF_251_251BDF0530_05031.jpg,4283,0,4283,DF,251
1077277_DF_251_251BDF0530_05079.jpg,5300,0,5300,DF,251
1077333_DF_251_251BDF0530_05183.jpg,2339,0,2339,DF,251
1077334_DF_251_251BDF0530_05186.jpg,15234,0,15234,DF,251
1077335_DF_251_251BDF0530_05188.jpg,22956,0,22956,DF,251
1077336_DF_251_251BDF0530_05189.jpg,12636,0,12636,DF,251
1077337_DF_251_251BDF0530_05192.jpg,7100,0,7100,DF,251
1077338_DF_251_251BDF0530_05194.jpg,6879,0,6879,DF,251
1077339_DF_251_251BDF0530_05197.jpg,7452,0,7452,DF,251
1077340_DF_251_251BDF0530_05199.jpg,9441,0,9441,DF,251
1077341_DF_251_251BDF0530_05200.jpg,1115,0,1115,DF,251
1077522_DF_251_251BDF0530_05541.jpg,0,1040,1040,DF,251
1077523_DF_251_251BDF0530_05543.jpg,0,2770,2770,DF,251
1078404_DF_010_010BDF0030_1_00191.jpg,1,2151,2152,DF,010
1080089_DF_010_010BDF0030_1_03336.jpg,17,8093,8110,DF,010
1081349_DF_080_080BDF0070_00023.jpg,1928,0,1928,DF,080
1081350_DF_080_080BDF0070_00026.jpg,10019,0,10019,DF,080
1081458_DF_080_080BDF0070_00239.jpg,12810,1695,14505,DF,080
1081472_DF_080_080BDF0070_00264.jpg,6407,0,6407,DF,080
1081477_DF_080_080BDF0070_00272.jpg,13309,0,13309,DF,080
1081487_DF_080_080BDF0070_00291.jpg,14434,0,14434,DF,080
1081492_DF_080_080BDF0070_00299.jpg,8258,0,8258,DF,080
1081495_DF_080_080BDF0070_00305.jpg,28699,0,28699,DF,080
1081496_DF_080_080BDF0070_00307.jpg,42238,0,42238,DF,080
1081499_DF_080_080BDF0070_00313.jpg,15966,0,15966,DF,080
1081502_DF_080_080BDF0070_00319.jpg,20447,0,20447,DF,080
1081503_DF_080_080BDF0070_00321.jpg,14742,0,14742,DF,080
1081506_DF_080_080BDF0070_00327.jpg,22012,0,22012,DF,080
1081508_DF_080_080BDF0070_00331.jpg,13061,0,13061,DF,080
1081509_DF_080_080BDF0070_00332.jpg,16877,0,16877,DF,080
1081511_DF_080_080BDF0070_00336.jpg,8849,0,8849,DF,080
1081512_DF_080_080BDF0070_00338.jpg,4888,0,4888,DF,080
1081514_DF_080_080BDF0070_00342.jpg,31932,0,31932,DF,080
1081515_DF_080_080BDF0070_00344.jpg,10490,0,10490,DF,080
1081516_DF_080_080BDF0070_00346.jpg,18695,0,18695,DF,080
1081519_DF_080_080BDF0070_00351.jpg,22153,0,22153,DF,080
1081523_DF_080_080BDF0070_00360.jpg,20150,0,20150,DF,080
1081524_DF_080_080BDF0070_00362.jpg,7357,0,7357,DF,080
1081525_DF_080_080BDF0070_00364.jpg,23913,0,23913,DF,080
1081538_DF_080_080BDF0070_00388.jpg,2739,0,2739,DF,080
1081539_DF_080_080BDF0070_00390.jpg,24083,0,24083,DF,080
1081558_DF_080_080BDF0070_00423.jpg,6643,0,6643,DF,080
1081559_DF_080_080BDF0070_00425.jpg,13765,0,13765,DF,080
1081565_DF_080_080BDF0070_00435.jpg,9724,0,9724,DF,080
1081568_DF_080_080BDF0070_00441.jpg,14995,0,14995,DF,080
1081576_DF_080_080BDF0070_00455.jpg,6121,0,6121,DF,080
1081577_DF_080_080BDF0070_00457.jpg,12191,0,12191,DF,080
1081579_DF_080_080BDF0070_00460.jpg,4049,0,4049,DF,080
1081589_DF_080_080BDF0070_00478.jpg,85,433,518,DF,080
1081595_DF_080_080BDF0070_00490.jpg,1540,0,1540,DF,080
1081597_DF_080_080BDF0070_00493.jpg,8572,0,8572,DF,080
1081598_DF_080_080BDF0070_00496.jpg,5207,0,5207,DF,080
1081599_DF_080_080BDF0070_00498.jpg,12749,0,12749,DF,080
1081605_DF_080_080BDF0070_00508.jpg,4742,0,4742,DF,080
1081606_DF_080_080BDF0070_00510.jpg,13951,0,13951,DF,080
1081660_DF_080_080BDF0070_00608.jpg,40197,0,40197,DF,080
1081661_DF_080_080BDF0070_00610.jpg,35599,0,35599,DF,080
1081670_DF_080_080BDF0070_00627.jpg,1100,0,1100,DF,080
1081672_DF_080_080BDF0070_00630.jpg,4387,0,4387,DF,080
1081677_DF_080_080BDF0070_00640.jpg,39502,0,39502,DF,080
1081678_DF_080_080BDF0070_00641.jpg,23150,0,23150,DF,080
1081728_DF_080_080BDF0070_00731.jpg,19120,0,19120,DF,080
1081729_DF_080_080BDF0070_00733.jpg,20527,0,20527,DF,080
1081738_DF_080_080BDF0070_00749.jpg,720,0,720,DF,080
1081739_DF_080_080BDF0070_00751.jpg,14014,0,14014,DF,080
1081740_DF_080_080BDF0070_00753.jpg,21156,0,21156,DF,080
1081757_DF_080_080BDF0070_00783.jpg,4330,0,4330,DF,080
1081770_DF_080_080BDF0070_00810.jpg,36138,1232,37370,DF,080
1081771_DF_080_080BDF0070_00811.jpg,23978,2909,26887,DF,080
1081792_DF_080_080BDF0070_00850.jpg,11154,0,11154,DF,080
1081800_DF_080_080BDF0070_00867.jpg,37986,0,37986,DF,080
1081803_DF_080_080BDF0070_00873.jpg,6041,0,6041,DF,080
1081805_DF_080_080BDF0070_00877.jpg,28554,0,28554,DF,080
1081806_DF_080_080BDF0070_00878.jpg,34308,0,34308,DF,080
1081807_DF_080_080BDF0070_00880.jpg,32932,0,32932,DF,080
1081808_DF_080_080BDF0070_00882.jpg,29113,0,29113,DF,080
1081809_DF_080_080BDF0070_00884.jpg,9574,0,9574,DF,080
1081812_DF_080_080BDF0070_00890.jpg,24872,0,24872,DF,080
1081813_DF_080_080BDF0070_00891.jpg,30007,0,30007,DF,080
1081817_DF_080_080BDF0070_00898.jpg,16688,0,16688,DF,080
1081818_DF_080_080BDF0070_00900.jpg,35163,0,35163,DF,080
1081828_DF_080_080BDF0070_00918.jpg,3040,0,3040,DF,080
1081890_DF_080_080BDF0070_01030.jpg,27306,0,27306,DF,080
1081891_DF_080_080BDF0070_01032.jpg,13202,0,13202,DF,080
1081894_DF_080_080BDF0070_01037.jpg,20573,33514,54087,DF,080
1081895_DF_080_080BDF0070_01039.jpg,40922,0,40922,DF,080
1081896_DF_080_080BDF0070_01041.jpg,15986,0,15986,DF,080
1081923_DF_080_080BDF0070_01095.jpg,2615,0,2615,DF,080
1082211_DF_080_080BDF0070_01699.jpg,36396,0,36396,DF,080
1082212_DF_080_080BDF0070_01703.jpg,32648,0,32648,DF,080
1082215_DF_080_080BDF0070_01712.jpg,19991,0,19991,DF,080
1082216_DF_080_080BDF0070_01715.jpg,23871,0,23871,DF,080
1082217_DF_080_080BDF0070_01718.jpg,34601,0,34601,DF,080
1082218_DF_080_080BDF0070_01721.jpg,22117,0,22117,DF,080
1082219_DF_080_080BDF0070_01724.jpg,2624,0,2624,DF,080
1082220_DF_080_080BDF0070_01727.jpg,3073,0,3073,DF,080
1082223_DF_080_080BDF0070_01734.jpg,48679,0,48679,DF,080
1082224_DF_080_080BDF0070_01737.jpg,64641,0,64641,DF,080
1082234_DF_080_080BDF0070_01764.jpg,28047,0,28047,DF,080
1082254_DF_080_080BDF0070_01831.jpg,95189,0,95189,DF,080
1082300_DF_080_080BDF0070_01927.jpg,60017,0,60017,DF,080
1082758_DF_080_080BDF0070_02801.jpg,14655,0,14655,DF,080
1082821_DF_080_080BDF0070_02915.jpg,6707,0,6707,DF,080
1082916_DF_080_080BDF0070_03088.jpg,8817,0,8817,DF,080
1082972_DF_080_080BDF0070_03191.jpg,18430,0,18430,DF,080
1083021_DF_080_080BDF0070_03280.jpg,622,6212,6834,DF,080
1083104_DF_080_080BDF0070_03436.jpg,7562,0,7562,DF,080
1083231_DF_080_080BDF0070_03759.jpg,6966,0,6966,DF,080
1083252_DF_080_080BDF0070_03824.jpg,8256,1311,9567,DF,080
1083253_DF_080_080BDF0070_03828.jpg,14573,0,14573,DF,080
1083340_DF_080_080BDF0070_04015.jpg,8608,0,8608,DF,080
1083731_DF_080_080BDF0090_00251.jpg,15602,0,15602,DF,080
1083752_DF_080_080BDF0090_00291.jpg,0,3546,3546,DF,080
1083758_DF_080_080BDF0090_00303.jpg,11782,0,11782,DF,080
1083771_DF_080_080BDF0090_00328.jpg,9803,0,9803,DF,080
1083772_DF_080_080BDF0090_00331.jpg,8798,0,8798,DF,080
1083773_DF_080_080BDF0090_00332.jpg,8403,0,8403,DF,080
1083774_DF_080_080BDF0090_00334.jpg,14243,0,14243,DF,080
1083783_DF_080_080BDF0090_00352.jpg,29517,0,29517,DF,080
1083784_DF_080_080BDF0090_00354.jpg,42650,0,42650,DF,080
1083785_DF_080_080BDF0090_00355.jpg,36541,0,36541,DF,080
1083786_DF_080_080BDF0090_00357.jpg,16280,0,16280,DF,080
1083787_DF_080_080BDF0090_00359.jpg,9673,0,9673,DF,080
1083821_DF_080_080BDF0090_00423.jpg,1589,0,1589,DF,080
1083994_DF_080_080BDF0090_00778.jpg,17062,0,17062,DF,080
1083995_DF_080_080BDF0090_00780.jpg,7736,0,7736,DF,080
1084105_DF_080_080BDF0090_00984.jpg,16171,0,16171,DF,080
1084107_DF_080_080BDF0090_00987.jpg,25329,0,25329,DF,080
1084108_DF_080_080BDF0090_00989.jpg,9913,0,9913,DF,080
1084119_DF_080_080BDF0090_01009.jpg,12218,0,12218,DF,080
1084157_DF_080_080BDF0090_01081.jpg,9622,0,9622,DF,080
1084257_DF_080_080BDF0090_01340.jpg,3657,0,3657,DF,080
1084259_DF_080_080BDF0090_01344.jpg,17636,0,17636,DF,080
1084264_DF_080_080BDF0090_01353.jpg,9139,0,9139,DF,080
1084273_DF_080_080BDF0090_01371.jpg,8148,0,8148,DF,080
1084274_DF_080_080BDF0090_01373.jpg,4352,0,4352,DF,080
1084279_DF_080_080BDF0090_01382.jpg,26479,1431,27910,DF,080
1084280_DF_080_080BDF0090_01384.jpg,42807,3565,46372,DF,080
1084281_DF_080_080BDF0090_01385.jpg,33511,1102,34613,DF,080
1084296_DF_080_080BDF0090_01413.jpg,15201,0,15201,DF,080
1084307_DF_080_080BDF0090_01435.jpg,5420,0,5420,DF,080
1084314_DF_080_080BDF0090_01448.jpg,7000,0,7000,DF,080
1084318_DF_080_080BDF0090_01454.jpg,4038,0,4038,DF,080
1084319_DF_080_080BDF0090_01456.jpg,7882,0,7882,DF,080
1084344_DF_080_080BDF0090_01499.jpg,5901,0,5901,DF,080
1084345_DF_080_080BDF0090_01501.jpg,8567,0,8567,DF,080
1084354_DF_080_080BDF0090_01515.jpg,22847,0,22847,DF,080
1084355_DF_080_080BDF0090_01517.jpg,21585,0,21585,DF,080
1084356_DF_080_080BDF0090_01519.jpg,6199,0,6199,DF,080
1084371_DF_080_080BDF0090_01543.jpg,1399,0,1399,DF,080
1084379_DF_080_080BDF0090_01558.jpg,5673,0,5673,DF,080
1084380_DF_080_080BDF0090_01559.jpg,25744,0,25744,DF,080
1084381_DF_080_080BDF0090_01560.jpg,24487,0,24487,DF,080
1084398_DF_080_080BDF0090_01592.jpg,16521,0,16521,DF,080
1084399_DF_080_080BDF0090_01595.jpg,19314,0,19314,DF,080
1084418_DF_080_080BDF0090_01632.jpg,22410,0,22410,DF,080
1084435_DF_080_080BDF0090_01660.jpg,0,2188,2188,DF,080
1084437_DF_080_080BDF0090_01663.jpg,25326,17215,42541,DF,080
1084438_DF_080_080BDF0090_01665.jpg,9319,0,9319,DF,080
1084440_DF_080_080BDF0090_01668.jpg,15009,0,15009,DF,080
1084455_DF_080_080BDF0090_01696.jpg,13128,0,13128,DF,080
1084457_DF_080_080BDF0090_01700.jpg,22392,0,22392,DF,080
1084458_DF_080_080BDF0090_01701.jpg,14950,0,14950,DF,080
1084459_DF_080_080BDF0090_01703.jpg,12191,0,12191,DF,080
1084513_DF_080_080BDF0090_01797.jpg,13961,0,13961,DF,080
1084514_DF_080_080BDF0090_01799.jpg,945,0,945,DF,080
1084517_DF_080_080BDF0090_01804.jpg,13991,0,13991,DF,080
1084527_DF_080_080BDF0090_01823.jpg,5700,0,5700,DF,080
1084529_DF_080_080BDF0090_01827.jpg,5997,1469,7466,DF,080
1084530_DF_080_080BDF0090_01828.jpg,5339,1987,7326,DF,080
1084546_DF_080_080BDF0090_01855.jpg,8,4457,4465,DF,080
1084547_DF_080_080BDF0090_01856.jpg,51,11906,11957,DF,080
1085367_DF_080_080BDF0090_03485.jpg,30590,0,30590,DF,080
1085368_DF_080_080BDF0090_03487.jpg,14252,0,14252,DF,080
1085369_DF_080_080BDF0090_03488.jpg,20794,0,20794,DF,080
1085376_DF_080_080BDF0090_03501.jpg,16007,0,16007,DF,080
1085383_DF_080_080BDF0090_03514.jpg,17095,0,17095,DF,080
1085386_DF_080_080BDF0090_03519.jpg,957,0,957,DF,080
1085393_DF_080_080BDF0090_03531.jpg,885,0,885,DF,080
1085394_DF_080_080BDF0090_03533.jpg,11304,0,11304,DF,080
1085398_DF_080_080BDF0090_03541.jpg,17004,0,17004,DF,080
1085399_DF_080_080BDF0090_03543.jpg,28162,0,28162,DF,080
1085400_DF_080_080BDF0090_03545.jpg,28291,0,28291,DF,080
1085404_DF_080_080BDF0090_03552.jpg,4741,0,4741,DF,080
1085406_DF_080_080BDF0090_03556.jpg,2118,0,2118,DF,080
1085408_DF_080_080BDF0090_03560.jpg,19830,0,19830,DF,080
1085409_DF_080_080BDF0090_03562.jpg,16021,0,16021,DF,080
1085429_DF_080_080BDF0090_03601.jpg,16095,0,16095,DF,080
1085449_DF_080_080BDF0090_03640.jpg,2483,0,2483,DF,080
1085450_DF_080_080BDF0090_03642.jpg,10442,5554,15996,DF,080
1085451_DF_080_080BDF0090_03644.jpg,9046,13330,22376,DF,080
1089713_DF_070_070BDF0050_04713.jpg,1140,0,1140,DF,070
1089879_DF_070_070BDF0050_05037.jpg,664,5127,5791,DF,070
1090135_DF_070_070BDF0050_05559.jpg,568,0,568,DF,070
1090167_DF_070_070BDF0050_05616.jpg,1320,0,1320,DF,070
1090284_DF_070_070BDF0050_05831.jpg,7709,0,7709,DF,070
1090286_DF_070_070BDF0050_05835.jpg,3396,0,3396,DF,070
1090287_DF_070_070BDF0050_05837.jpg,7269,0,7269,DF,070
1090288_DF_070_070BDF0050_05839.jpg,5655,0,5655,DF,070
1090300_DF_070_070BDF0050_05861.jpg,2680,0,2680,DF,070
1090501_DF_070_070BDF0050_06235.jpg,1968,0,1968,DF,070
1090503_DF_070_070BDF0050_06238.jpg,6637,0,6637,DF,070
1090617_DF_070_070BDF0050_06453.jpg,34804,0,34804,DF,070
1090732_DF_070_070BDF0050_06657.jpg,8971,0,8971,DF,070
1090864_DF_070_070BDF0050_06899.jpg,6200,0,6200,DF,070
1091094_DF_070_070BDF0050_07370.jpg,49,0,49,DF,070
1091095_DF_070_070BDF0050_07372.jpg,3259,0,3259,DF,070
1091170_DF_070_070BDF0050_07510.jpg,998,0,998,DF,070
1091171_DF_070_070BDF0050_07512.jpg,9841,0,9841,DF,070
1091172_DF_070_070BDF0050_07513.jpg,18361,0,18361,DF,070
1091607_DF_251_251BDF0490_00579.jpg,3703,0,3703,DF,251
1091608_DF_251_251BDF0490_00581.jpg,3164,0,3164,DF,251
1091612_DF_251_251BDF0490_00589.jpg,6945,0,6945,DF,251
1091613_DF_251_251BDF0490_00590.jpg,9110,0,9110,DF,251
1091614_DF_251_251BDF0490_00592.jpg,13777,0,13777,DF,251
1091615_DF_251_251BDF0490_00594.jpg,13437,0,13437,DF,251
1091616_DF_251_251BDF0490_00595.jpg,8058,0,8058,DF,251
1091617_DF_251_251BDF0490_00597.jpg,5972,0,5972,DF,251
1091618_DF_251_251BDF0490_00599.jpg,17276,0,17276,DF,251
1091619_DF_251_251BDF0490_00601.jpg,20837,0,20837,DF,251
1091620_DF_251_251BDF0490_00603.jpg,19727,0,19727,DF,251
1091621_DF_251_251BDF0490_00604.jpg,8982,0,8982,DF,251
1091622_DF_251_251BDF0490_00606.jpg,11403,0,11403,DF,251
1091626_DF_251_251BDF0490_00613.jpg,1534,0,1534,DF,251
1091633_DF_251_251BDF0490_00627.jpg,1158,0,1158,DF,251
1091646_DF_251_251BDF0490_00650.jpg,1567,0,1567,DF,251
1091647_DF_251_251BDF0490_00652.jpg,10489,0,10489,DF,251
1091666_DF_251_251BDF0490_00687.jpg,4899,0,4899,DF,251
1091672_DF_251_251BDF0490_00698.jpg,838,0,838,DF,251
1091673_DF_251_251BDF0490_00700.jpg,2732,2374,5106,DF,251
1091695_DF_251_251BDF0490_00744.jpg,10260,0,10260,DF,251
1091703_DF_251_251BDF0490_00760.jpg,30903,0,30903,DF,251
1091704_DF_251_251BDF0490_00762.jpg,15288,0,15288,DF,251
1091706_DF_251_251BDF0490_00765.jpg,7192,0,7192,DF,251
1091707_DF_251_251BDF0490_00767.jpg,2433,0,2433,DF,251
1091708_DF_251_251BDF0490_00769.jpg,4285,0,4285,DF,251
1091711_DF_251_251BDF0490_00774.jpg,8953,0,8953,DF,251
1091715_DF_251_251BDF0490_00782.jpg,5699,0,5699,DF,251
1091717_DF_251_251BDF0490_00786.jpg,18542,0,18542,DF,251
1091718_DF_251_251BDF0490_00788.jpg,12522,0,12522,DF,251
1091723_DF_251_251BDF0490_00797.jpg,10993,0,10993,DF,251
1091724_DF_251_251BDF0490_00799.jpg,8522,0,8522,DF,251
1091725_DF_251_251BDF0490_00801.jpg,13079,0,13079,DF,251
1091726_DF_251_251BDF0490_00803.jpg,6544,0,6544,DF,251
1091727_DF_251_251BDF0490_00805.jpg,22531,0,22531,DF,251
1091729_DF_251_251BDF0490_00809.jpg,1645,0,1645,DF,251
1091730_DF_251_251BDF0490_00811.jpg,9761,0,9761,DF,251
1091731_DF_251_251BDF0490_00813.jpg,6893,0,6893,DF,251
1091732_DF_251_251BDF0490_00815.jpg,5861,0,5861,DF,251
1091733_DF_251_251BDF0490_00817.jpg,7020,0,7020,DF,251
1091736_DF_251_251BDF0490_00822.jpg,8432,0,8432,DF,251
1091738_DF_251_251BDF0490_00826.jpg,8981,0,8981,DF,251
1091739_DF_251_251BDF0490_00828.jpg,1659,0,1659,DF,251
1091744_DF_251_251BDF0490_00838.jpg,19357,0,19357,DF,251
1091748_DF_251_251BDF0490_00846.jpg,4587,0,4587,DF,251
1091749_DF_251_251BDF0490_00848.jpg,5186,0,5186,DF,251
1091751_DF_251_251BDF0490_00851.jpg,3853,0,3853,DF,251
1091753_DF_251_251BDF0490_00855.jpg,9259,0,9259,DF,251
1091754_DF_251_251BDF0490_00857.jpg,2349,0,2349,DF,251
1091756_DF_251_251BDF0490_00861.jpg,5975,0,5975,DF,251
1091762_DF_251_251BDF0490_00872.jpg,4347,0,4347,DF,251
1091763_DF_251_251BDF0490_00874.jpg,6597,0,6597,DF,251
1091769_DF_251_251BDF0490_00884.jpg,12986,0,12986,DF,251
1091773_DF_251_251BDF0490_00892.jpg,1454,0,1454,DF,251
1091774_DF_251_251BDF0490_00893.jpg,6944,0,6944,DF,251
1091777_DF_251_251BDF0490_00899.jpg,8417,0,8417,DF,251
1091778_DF_251_251BDF0490_00901.jpg,15977,0,15977,DF,251
1091781_DF_251_251BDF0490_00907.jpg,19942,0,19942,DF,251
1091783_DF_251_251BDF0490_00911.jpg,10196,0,10196,DF,251
1091788_DF_251_251BDF0490_00921.jpg,26995,0,26995,DF,251
1091803_DF_251_251BDF0490_00949.jpg,9765,0,9765,DF,251
1091804_DF_251_251BDF0490_00951.jpg,26959,0,26959,DF,251
1091808_DF_251_251BDF0490_00958.jpg,1972,0,1972,DF,251
1091809_DF_251_251BDF0490_00960.jpg,4808,0,4808,DF,251
1091810_DF_251_251BDF0490_00962.jpg,7480,0,7480,DF,251
1091811_DF_251_251BDF0490_00963.jpg,16097,0,16097,DF,251
1091812_DF_251_251BDF0490_00966.jpg,38294,0,38294,DF,251
1091813_DF_251_251BDF0490_00968.jpg,27072,0,27072,DF,251
1091814_DF_251_251BDF0490_00970.jpg,14028,0,14028,DF,251
1091819_DF_251_251BDF0490_00979.jpg,31052,0,31052,DF,251
1091828_DF_251_251BDF0490_00995.jpg,5329,0,5329,DF,251
1091829_DF_251_251BDF0490_00997.jpg,9414,0,9414,DF,251
1091844_DF_251_251BDF0490_01027.jpg,4540,0,4540,DF,251
1091845_DF_251_251BDF0490_01029.jpg,5686,0,5686,DF,251
1091851_DF_251_251BDF0490_01040.jpg,3048,0,3048,DF,251
1091864_DF_251_251BDF0490_01064.jpg,3176,0,3176,DF,251
1091866_DF_251_251BDF0490_01069.jpg,569,0,569,DF,251
1091869_DF_251_251BDF0490_01075.jpg,5442,0,5442,DF,251
1091870_DF_251_251BDF0490_01076.jpg,9073,0,9073,DF,251
1091872_DF_251_251BDF0490_01080.jpg,2801,0,2801,DF,251
1091873_DF_251_251BDF0490_01082.jpg,18813,0,18813,DF,251
1091874_DF_251_251BDF0490_01084.jpg,14257,0,14257,DF,251
1091882_DF_251_251BDF0490_01100.jpg,10095,0,10095,DF,251
1091885_DF_251_251BDF0490_01105.jpg,8443,0,8443,DF,251
1091886_DF_251_251BDF0490_01107.jpg,7342,0,7342,DF,251
1091888_DF_251_251BDF0490_01111.jpg,13450,0,13450,DF,251
1091889_DF_251_251BDF0490_01113.jpg,783,0,783,DF,251
1091890_DF_251_251BDF0490_01115.jpg,9012,0,9012,DF,251
1091901_DF_251_251BDF0490_01135.jpg,8531,0,8531,DF,251
1091908_DF_251_251BDF0490_01148.jpg,605,0,605,DF,251
1091912_DF_251_251BDF0490_01156.jpg,6663,0,6663,DF,251
1091913_DF_251_251BDF0490_01158.jpg,6000,0,6000,DF,251
1091915_DF_251_251BDF0490_01162.jpg,5835,0,5835,DF,251
1091917_DF_251_251BDF0490_01166.jpg,2670,0,2670,DF,251
1091921_DF_251_251BDF0490_01174.jpg,3076,0,3076,DF,251
1091923_DF_251_251BDF0490_01177.jpg,5834,0,5834,DF,251
1091927_DF_251_251BDF0490_01185.jpg,6104,0,6104,DF,251
1091928_DF_251_251BDF0490_01187.jpg,7719,0,7719,DF,251
1091929_DF_251_251BDF0490_01189.jpg,9069,0,9069,DF,251
1091930_DF_251_251BDF0490_01191.jpg,1578,0,1578,DF,251
1091931_DF_251_251BDF0490_01193.jpg,3396,0,3396,DF,251
1091932_DF_251_251BDF0490_01195.jpg,1253,0,1253,DF,251
1091933_DF_251_251BDF0490_01197.jpg,7015,0,7015,DF,251
1091935_DF_251_251BDF0490_01200.jpg,3815,0,3815,DF,251
1091937_DF_251_251BDF0490_01204.jpg,4715,0,4715,DF,251
1091945_DF_251_251BDF0490_01219.jpg,7957,0,7957,DF,251
1091955_DF_251_251BDF0490_01237.jpg,6971,0,6971,DF,251
1091959_DF_251_251BDF0490_01244.jpg,12790,0,12790,DF,251
1091960_DF_251_251BDF0490_01246.jpg,24914,0,24914,DF,251
1091961_DF_251_251BDF0490_01248.jpg,22656,0,22656,DF,251
1091962_DF_251_251BDF0490_01250.jpg,14082,0,14082,DF,251
1091965_DF_251_251BDF0490_01255.jpg,25699,0,25699,DF,251
1091966_DF_251_251BDF0490_01257.jpg,7514,0,7514,DF,251
1091970_DF_251_251BDF0490_01263.jpg,3120,0,3120,DF,251
1091971_DF_251_251BDF0490_01265.jpg,1718,0,1718,DF,251
1091974_DF_251_251BDF0490_01271.jpg,7962,0,7962,DF,251
1091978_DF_251_251BDF0490_01279.jpg,5149,0,5149,DF,251
1091982_DF_251_251BDF0490_01287.jpg,2527,0,2527,DF,251
1091993_DF_251_251BDF0490_01306.jpg,9551,0,9551,DF,251
1091995_DF_251_251BDF0490_01310.jpg,7050,0,7050,DF,251
1092007_DF_251_251BDF0490_01332.jpg,3939,0,3939,DF,251
1092030_DF_251_251BDF0490_01376.jpg,6369,0,6369,DF,251
1092033_DF_251_251BDF0490_01381.jpg,12234,0,12234,DF,251
1092054_DF_251_251BDF0490_01420.jpg,10071,0,10071,DF,251
1092055_DF_251_251BDF0490_01422.jpg,9087,0,9087,DF,251
1092056_DF_251_251BDF0490_01424.jpg,26753,0,26753,DF,251
1092061_DF_251_251BDF0490_01433.jpg,8707,0,8707,DF,251
1092062_DF_251_251BDF0490_01434.jpg,7399,0,7399,DF,251
1092064_DF_251_251BDF0490_01438.jpg,10227,0,10227,DF,251
1092067_DF_251_251BDF0490_01443.jpg,11863,0,11863,DF,251
1092068_DF_251_251BDF0490_01445.jpg,16027,0,16027,DF,251
1092070_DF_251_251BDF0490_01449.jpg,8658,0,8658,DF,251
1092078_DF_251_251BDF0490_01463.jpg,10308,0,10308,DF,251
1092079_DF_251_251BDF0490_01465.jpg,23995,0,23995,DF,251
1092081_DF_251_251BDF0490_01468.jpg,2801,0,2801,DF,251
1092082_DF_251_251BDF0490_01470.jpg,9562,0,9562,DF,251
1092083_DF_251_251BDF0490_01472.jpg,10503,0,10503,DF,251
1092085_DF_251_251BDF0490_01475.jpg,13918,0,13918,DF,251
1092086_DF_251_251BDF0490_01477.jpg,7464,0,7464,DF,251
1092098_DF_251_251BDF0490_01498.jpg,11346,0,11346,DF,251
1092100_DF_251_251BDF0490_01502.jpg,10468,0,10468,DF,251
1092102_DF_251_251BDF0490_01506.jpg,8268,0,8268,DF,251
1092106_DF_251_251BDF0490_01513.jpg,11139,0,11139,DF,251
1092108_DF_251_251BDF0490_01516.jpg,11744,0,11744,DF,251
1092109_DF_251_251BDF0490_01519.jpg,6616,0,6616,DF,251
1092284_DF_251_251BDF0490_01839.jpg,17537,1604,19141,DF,251
1092292_DF_251_251BDF0490_01853.jpg,0,1654,1654,DF,251
1092293_DF_251_251BDF0490_01855.jpg,2587,4913,7500,DF,251
1092307_DF_251_251BDF0490_01882.jpg,28980,657,29637,DF,251
1092308_DF_251_251BDF0490_01884.jpg,18831,2053,20884,DF,251
1092319_DF_251_251BDF0490_01904.jpg,23377,1501,24878,DF,251
1092335_DF_251_251BDF0490_01934.jpg,40424,1809,42233,DF,251
1092480_DF_251_251BDF0052_00025.jpg,104770,0,104770,DF,251
1092482_DF_251_251BDF0052_00031.jpg,92985,0,92985,DF,251
1092483_DF_251_251BDF0052_00033.jpg,47427,2713,50140,DF,251
1092484_DF_251_251BDF0052_00036.jpg,86503,0,86503,DF,251
1092485_DF_251_251BDF0052_00038.jpg,55163,0,55163,DF,251
1092499_DF_251_251BDF0052_00068.jpg,16776,0,16776,DF,251
1092500_DF_251_251BDF0052_00070.jpg,19332,0,19332,DF,251
1092501_DF_251_251BDF0052_00072.jpg,20723,0,20723,DF,251
1092528_DF_251_251BDF0052_00121.jpg,12816,0,12816,DF,251
1092529_DF_251_251BDF0052_00122.jpg,9690,0,9690,DF,251
1092531_DF_251_251BDF0052_00126.jpg,38417,0,38417,DF,251
1092532_DF_251_251BDF0052_00127.jpg,21442,0,21442,DF,251
1092533_DF_251_251BDF0052_00129.jpg,25009,0,25009,DF,251
1092540_DF_251_251BDF0052_00142.jpg,31221,0,31221,DF,251
1092541_DF_251_251BDF0052_00143.jpg,21449,0,21449,DF,251
1092542_DF_251_251BDF0052_00145.jpg,19487,0,19487,DF,251
1092543_DF_251_251BDF0052_00148.jpg,26450,0,26450,DF,251
1092544_DF_251_251BDF0052_00150.jpg,18773,0,18773,DF,251
1092545_DF_251_251BDF0052_00151.jpg,21078,0,21078,DF,251
1092546_DF_251_251BDF0052_00153.jpg,20262,0,20262,DF,251
1092547_DF_251_251BDF0052_00155.jpg,23181,0,23181,DF,251
1092548_DF_251_251BDF0052_00157.jpg,15637,0,15637,DF,251
1092549_DF_251_251BDF0052_00159.jpg,20228,0,20228,DF,251
1092550_DF_251_251BDF0052_00160.jpg,22546,0,22546,DF,251
1092551_DF_251_251BDF0052_00162.jpg,14322,0,14322,DF,251
1092552_DF_251_251BDF0052_00164.jpg,4735,0,4735,DF,251
1092553_DF_251_251BDF0052_00166.jpg,8631,0,8631,DF,251
1092554_DF_251_251BDF0052_00167.jpg,17660,0,17660,DF,251
1092555_DF_251_251BDF0052_00169.jpg,20853,0,20853,DF,251
1092556_DF_251_251BDF0052_00170.jpg,25586,0,25586,DF,251
1092658_DF_251_251BDF0052_00345.jpg,25569,0,25569,DF,251
1092659_DF_251_251BDF0052_00347.jpg,23329,0,23329,DF,251
1092660_DF_251_251BDF0052_00348.jpg,31407,1437,32844,DF,251
1092661_DF_251_251BDF0052_00350.jpg,30232,3709,33941,DF,251
1092662_DF_251_251BDF0052_00352.jpg,24131,0,24131,DF,251
1092741_DF_251_251BDF0052_00490.jpg,11549,0,11549,DF,251
1092743_DF_251_251BDF0052_00494.jpg,28268,0,28268,DF,251
1092744_DF_251_251BDF0052_00496.jpg,29968,0,29968,DF,251
1092745_DF_251_251BDF0052_00497.jpg,22176,0,22176,DF,251
1092753_DF_251_251BDF0052_00511.jpg,6193,0,6193,DF,251
1092757_DF_251_251BDF0052_00518.jpg,49787,0,49787,DF,251
1092759_DF_251_251BDF0052_00521.jpg,7063,0,7063,DF,251
1092760_DF_251_251BDF0052_00523.jpg,48874,0,48874,DF,251
1092761_DF_251_251BDF0052_00524.jpg,33425,0,33425,DF,251
1092762_DF_251_251BDF0052_00526.jpg,42723,0,42723,DF,251
1092775_DF_251_251BDF0052_00548.jpg,15766,0,15766,DF,251
1092792_DF_251_251BDF0052_00577.jpg,35851,0,35851,DF,251
1092794_DF_251_251BDF0052_00581.jpg,55729,0,55729,DF,251
1092799_DF_251_251BDF0052_00590.jpg,11779,0,11779,DF,251
1092800_DF_251_251BDF0052_00591.jpg,20793,0,20793,DF,251
1092802_DF_251_251BDF0052_00595.jpg,29358,0,29358,DF,251
1092803_DF_251_251BDF0052_00597.jpg,9352,0,9352,DF,251
1092804_DF_251_251BDF0052_00599.jpg,19306,0,19306,DF,251
1092806_DF_251_251BDF0052_00602.jpg,17757,0,17757,DF,251
1092808_DF_251_251BDF0052_00606.jpg,21604,0,21604,DF,251
1092809_DF_251_251BDF0052_00607.jpg,23880,0,23880,DF,251
1092811_DF_251_251BDF0052_00611.jpg,29644,0,29644,DF,251
1092813_DF_251_251BDF0052_00615.jpg,21832,0,21832,DF,251
1092814_DF_251_251BDF0052_00616.jpg,26752,0,26752,DF,251
1092815_DF_251_251BDF0052_00618.jpg,7402,0,7402,DF,251
1092816_DF_251_251BDF0052_00620.jpg,27288,0,27288,DF,251
1092818_DF_251_251BDF0052_00624.jpg,28961,0,28961,DF,251
1092819_DF_251_251BDF0052_00625.jpg,45569,0,45569,DF,251
1092820_DF_251_251BDF0052_00627.jpg,20591,0,20591,DF,251
1092821_DF_251_251BDF0052_00629.jpg,37433,0,37433,DF,251
1092822_DF_251_251BDF0052_00631.jpg,7667,0,7667,DF,251
1092823_DF_251_251BDF0052_00633.jpg,16482,0,16482,DF,251
1092824_DF_251_251BDF0052_00634.jpg,22654,0,22654,DF,251
1092825_DF_251_251BDF0052_00636.jpg,39789,0,39789,DF,251
1092828_DF_251_251BDF0052_00641.jpg,55236,0,55236,DF,251
1092830_DF_251_251BDF0052_00645.jpg,35312,0,35312,DF,251
1092834_DF_251_251BDF0052_00651.jpg,35533,0,35533,DF,251
1092836_DF_251_251BDF0052_00655.jpg,31731,0,31731,DF,251
1092838_DF_251_251BDF0052_00658.jpg,39523,0,39523,DF,251
1092839_DF_251_251BDF0052_00660.jpg,38044,0,38044,DF,251
1092843_DF_251_251BDF0052_00667.jpg,37165,0,37165,DF,251
1092844_DF_251_251BDF0052_00669.jpg,26209,0,26209,DF,251
1092845_DF_251_251BDF0052_00671.jpg,27791,0,27791,DF,251
1092846_DF_251_251BDF0052_00673.jpg,20375,0,20375,DF,251
1092847_DF_251_251BDF0052_00674.jpg,29721,0,29721,DF,251
1092849_DF_251_251BDF0052_00678.jpg,31627,0,31627,DF,251
1092851_DF_251_251BDF0052_00681.jpg,58608,0,58608,DF,251
1092852_DF_251_251BDF0052_00683.jpg,24850,0,24850,DF,251
1092853_DF_251_251BDF0052_00685.jpg,28468,0,28468,DF,251
1092854_DF_251_251BDF0052_00687.jpg,14599,0,14599,DF,251
1092856_DF_251_251BDF0052_00690.jpg,5550,0,5550,DF,251
1092857_DF_251_251BDF0052_00692.jpg,32684,0,32684,DF,251
1092858_DF_251_251BDF0052_00694.jpg,30801,0,30801,DF,251
1092860_DF_251_251BDF0052_00697.jpg,20340,0,20340,DF,251
1092861_DF_251_251BDF0052_00699.jpg,28857,0,28857,DF,251
1092862_DF_251_251BDF0052_00701.jpg,21720,0,21720,DF,251
1092865_DF_251_251BDF0052_00706.jpg,2723,0,2723,DF,251
1092866_DF_251_251BDF0052_00708.jpg,21284,0,21284,DF,251
1092867_DF_251_251BDF0052_00710.jpg,21675,0,21675,DF,251
1092868_DF_251_251BDF0052_00711.jpg,35343,0,35343,DF,251
1092869_DF_251_251BDF0052_00713.jpg,19664,0,19664,DF,251
1092871_DF_251_251BDF0052_00716.jpg,22129,0,22129,DF,251
1092872_DF_251_251BDF0052_00718.jpg,22101,0,22101,DF,251
1092873_DF_251_251BDF0052_00720.jpg,59735,0,59735,DF,251
1092874_DF_251_251BDF0052_00722.jpg,31103,0,31103,DF,251
1092875_DF_251_251BDF0052_00723.jpg,27572,0,27572,DF,251
1092876_DF_251_251BDF0052_00725.jpg,21049,0,21049,DF,251
1092877_DF_251_251BDF0052_00727.jpg,20498,0,20498,DF,251
1092881_DF_251_251BDF0052_00734.jpg,10336,0,10336,DF,251
1092885_DF_251_251BDF0052_00741.jpg,5433,0,5433,DF,251
1092886_DF_251_251BDF0052_00743.jpg,14751,0,14751,DF,251
1092888_DF_251_251BDF0052_00746.jpg,19738,0,19738,DF,251
1092889_DF_251_251BDF0052_00748.jpg,44228,0,44228,DF,251
1092890_DF_251_251BDF0052_00750.jpg,10403,0,10403,DF,251
1092891_DF_251_251BDF0052_00751.jpg,14297,0,14297,DF,251
1092892_DF_251_251BDF0052_00753.jpg,29899,0,29899,DF,251
1092893_DF_251_251BDF0052_00755.jpg,25406,0,25406,DF,251
1092894_DF_251_251BDF0052_00757.jpg,24703,0,24703,DF,251
1092895_DF_251_251BDF0052_00759.jpg,13768,0,13768,DF,251
1092900_DF_251_251BDF0052_00768.jpg,31194,0,31194,DF,251
1092901_DF_251_251BDF0052_00770.jpg,11858,0,11858,DF,251
1092902_DF_251_251BDF0052_00771.jpg,10398,0,10398,DF,251
1092903_DF_251_251BDF0052_00773.jpg,24204,0,24204,DF,251
1092904_DF_251_251BDF0052_00775.jpg,46391,0,46391,DF,251
1092906_DF_251_251BDF0052_00778.jpg,71725,0,71725,DF,251
1092907_DF_251_251BDF0052_00780.jpg,39962,0,39962,DF,251
1092936_DF_251_251BDF0052_00831.jpg,8850,0,8850,DF,251
1092937_DF_251_251BDF0052_00833.jpg,21408,1148,22556,DF,251
1092938_DF_251_251BDF0052_00835.jpg,45200,3031,48231,DF,251
1092940_DF_251_251BDF0052_00838.jpg,21586,0,21586,DF,251
1092942_DF_251_251BDF0052_00841.jpg,12941,0,12941,DF,251
1092944_DF_251_251BDF0052_00844.jpg,3261,0,3261,DF,251
1092945_DF_251_251BDF0052_00846.jpg,19898,0,19898,DF,251
1092946_DF_251_251BDF0052_00848.jpg,4854,0,4854,DF,251
1092947_DF_251_251BDF0052_00849.jpg,12958,0,12958,DF,251
1092948_DF_251_251BDF0052_00851.jpg,24488,0,24488,DF,251
1092954_DF_251_251BDF0052_00863.jpg,3191,0,3191,DF,251
1092955_DF_251_251BDF0052_00865.jpg,8082,0,8082,DF,251
1092957_DF_251_251BDF0052_00869.jpg,8174,0,8174,DF,251
1092958_DF_251_251BDF0052_00870.jpg,7236,0,7236,DF,251
1092959_DF_251_251BDF0052_00872.jpg,27701,0,27701,DF,251
1092960_DF_251_251BDF0052_00874.jpg,29529,0,29529,DF,251
1092961_DF_251_251BDF0052_00876.jpg,20044,0,20044,DF,251
1092962_DF_251_251BDF0052_00877.jpg,30644,0,30644,DF,251
1092965_DF_251_251BDF0052_00883.jpg,21871,0,21871,DF,251
1092966_DF_251_251BDF0052_00885.jpg,14752,0,14752,DF,251
1092978_DF_251_251BDF0052_00905.jpg,5757,0,5757,DF,251
1092980_DF_251_251BDF0052_00909.jpg,27034,0,27034,DF,251
1092981_DF_251_251BDF0052_00911.jpg,34104,0,34104,DF,251
1092982_DF_251_251BDF0052_00912.jpg,37329,0,37329,DF,251
1092983_DF_251_251BDF0052_00914.jpg,25139,0,25139,DF,251
1092987_DF_251_251BDF0052_00921.jpg,13787,0,13787,DF,251
1092988_DF_251_251BDF0052_00923.jpg,35820,0,35820,DF,251
1092989_DF_251_251BDF0052_00925.jpg,20990,0,20990,DF,251
1092990_DF_251_251BDF0052_00927.jpg,34104,0,34104,DF,251
1092991_DF_251_251BDF0052_00928.jpg,31692,0,31692,DF,251
1092992_DF_251_251BDF0052_00931.jpg,39053,0,39053,DF,251
1092993_DF_251_251BDF0052_00932.jpg,39601,0,39601,DF,251
1092994_DF_251_251BDF0052_00934.jpg,33027,0,33027,DF,251
1092995_DF_251_251BDF0052_00936.jpg,35808,0,35808,DF,251
1092996_DF_251_251BDF0052_00937.jpg,31923,0,31923,DF,251
1092998_DF_251_251BDF0052_00941.jpg,15182,0,15182,DF,251
1093000_DF_251_251BDF0052_00945.jpg,9848,0,9848,DF,251
1093001_DF_251_251BDF0052_00947.jpg,10031,0,10031,DF,251
1093003_DF_251_251BDF0052_00950.jpg,12570,0,12570,DF,251
1093004_DF_251_251BDF0052_00952.jpg,31389,0,31389,DF,251
1093005_DF_251_251BDF0052_00953.jpg,18647,0,18647,DF,251
1093006_DF_251_251BDF0052_00955.jpg,15785,0,15785,DF,251
1093012_DF_251_251BDF0052_00966.jpg,3809,0,3809,DF,251
1093013_DF_251_251BDF0052_00968.jpg,17230,0,17230,DF,251
1093014_DF_251_251BDF0052_00970.jpg,29212,0,29212,DF,251
1093015_DF_251_251BDF0052_00971.jpg,24241,0,24241,DF,251
1093016_DF_251_251BDF0052_00973.jpg,23764,0,23764,DF,251
1093017_DF_251_251BDF0052_00975.jpg,51981,0,51981,DF,251
1093018_DF_251_251BDF0052_00976.jpg,33389,0,33389,DF,251
1093020_DF_251_251BDF0052_00980.jpg,40626,0,40626,DF,251
1093021_DF_251_251BDF0052_00982.jpg,43788,0,43788,DF,251
1093022_DF_251_251BDF0052_00984.jpg,113297,0,113297,DF,251
1093023_DF_251_251BDF0052_00986.jpg,84657,0,84657,DF,251
1093024_DF_251_251BDF0052_00987.jpg,80073,0,80073,DF,251
1093082_DF_251_251BDF0052_01089.jpg,17266,0,17266,DF,251
1093084_DF_251_251BDF0052_01092.jpg,43019,0,43019,DF,251
1093097_DF_251_251BDF0052_01115.jpg,32093,0,32093,DF,251
1093098_DF_251_251BDF0052_01116.jpg,89104,0,89104,DF,251
1093099_DF_251_251BDF0052_01118.jpg,36358,0,36358,DF,251
1093100_DF_251_251BDF0052_01120.jpg,23414,0,23414,DF,251
1093101_DF_251_251BDF0052_01121.jpg,56367,0,56367,DF,251
1093102_DF_251_251BDF0052_01123.jpg,29974,0,29974,DF,251
1093203_DF_251_251BDF0052_01334.jpg,1505,0,1505,DF,251
1093250_DF_251_251BDF0052_01416.jpg,2625,0,2625,DF,251
1093251_DF_251_251BDF0052_01417.jpg,13373,0,13373,DF,251
1093285_DF_251_251BDF0052_01476.jpg,69,1326,1395,DF,251
1093337_DF_251_251BDF0052_01595.jpg,1215,0,1215,DF,251
1093338_DF_251_251BDF0052_01597.jpg,21418,0,21418,DF,251
1093340_DF_251_251BDF0052_01600.jpg,5355,0,5355,DF,251
1093341_DF_251_251BDF0052_01602.jpg,17193,0,17193,DF,251
1093490_DF_251_251BDF0052_01857.jpg,7214,0,7214,DF,251
1093506_DF_251_251BDF0052_01885.jpg,6650,1380,8030,DF,251
1093507_DF_251_251BDF0052_01886.jpg,13964,3566,17530,DF,251
1093532_DF_251_251BDF0052_01928.jpg,482,282,764,DF,251
1093533_DF_251_251BDF0052_01930.jpg,17564,0,17564,DF,251
1093534_DF_251_251BDF0052_01931.jpg,9396,1223,10619,DF,251
1093596_DF_251_251BDF0052_02035.jpg,1307,0,1307,DF,251
1093597_DF_251_251BDF0052_02037.jpg,1161,0,1161,DF,251
1093728_DF_251_251BDF0052_02259.jpg,1145,2314,3459,DF,251
1093878_DF_251_251BDF0052_02531.jpg,20795,0,20795,DF,251
1093880_DF_251_251BDF0052_02535.jpg,998,0,998,DF,251
1093881_DF_251_251BDF0052_02537.jpg,6750,0,6750,DF,251
1093927_DF_251_251BDF0052_02620.jpg,6923,471,7394,DF,251
1093928_DF_251_251BDF0052_02622.jpg,6140,1049,7189,DF,251
1093936_DF_251_251BDF0052_02637.jpg,1628,0,1628,DF,251
1093965_DF_251_251BDF0052_02688.jpg,2610,2268,4878,DF,251
1093966_DF_251_251BDF0052_02690.jpg,2162,1752,3914,DF,251
1093982_DF_251_251BDF0052_02720.jpg,337,0,337,DF,251
1094000_DF_251_251BDF0052_02753.jpg,12854,0,12854,DF,251
1094001_DF_251_251BDF0052_02755.jpg,22608,0,22608,DF,251
1094002_DF_251_251BDF0052_02756.jpg,16458,0,16458,DF,251
1094047_DF_251_251BDF0052_02839.jpg,137,28512,28649,DF,251
1094173_DF_251_251BDF0052_03073.jpg,15123,0,15123,DF,251
1094241_DF_251_251BDF0052_03202.jpg,3355,0,3355,DF,251
1094242_DF_251_251BDF0052_03203.jpg,5910,0,5910,DF,251
1094243_DF_251_251BDF0052_03205.jpg,8513,0,8513,DF,251
1094244_DF_251_251BDF0052_03207.jpg,4170,0,4170,DF,251
1094247_DF_251_251BDF0052_03214.jpg,19693,0,19693,DF,251
1094248_DF_251_251BDF0052_03216.jpg,21122,0,21122,DF,251
1094253_DF_251_251BDF0052_03226.jpg,12529,0,12529,DF,251
1094254_DF_251_251BDF0052_03227.jpg,18473,0,18473,DF,251
1094256_DF_251_251BDF0052_03232.jpg,7237,0,7237,DF,251
1094259_DF_251_251BDF0052_03238.jpg,22991,0,22991,DF,251
1094260_DF_251_251BDF0052_03239.jpg,18346,0,18346,DF,251
1094261_DF_251_251BDF0052_03241.jpg,12922,0,12922,DF,251
1094275_DF_251_251BDF0052_03267.jpg,1798,0,1798,DF,251
1094276_DF_251_251BDF0052_03269.jpg,6856,0,6856,DF,251
1094279_DF_251_251BDF0052_03275.jpg,7859,0,7859,DF,251
1094285_DF_251_251BDF0052_03285.jpg,16376,0,16376,DF,251
1094287_DF_251_251BDF0052_03289.jpg,9642,0,9642,DF,251
1094288_DF_251_251BDF0052_03291.jpg,7527,0,7527,DF,251
1094289_DF_251_251BDF0052_03293.jpg,8729,0,8729,DF,251
1094543_DF_251_251BDF0052_03762.jpg,2518,0,2518,DF,251
1094544_DF_251_251BDF0052_03764.jpg,14818,0,14818,DF,251
1094551_DF_251_251BDF0052_03777.jpg,24172,0,24172,DF,251
1094552_DF_251_251BDF0052_03779.jpg,9628,0,9628,DF,251
1094553_DF_251_251BDF0052_03781.jpg,17672,0,17672,DF,251
1094702_DF_251_251BDF0052_04058.jpg,5222,0,5222,DF,251
1094911_DF_251_251BDF0052_04494.jpg,32175,0,32175,DF,251
1094912_DF_251_251BDF0052_04497.jpg,13475,0,13475,DF,251
1095846_DF_070_070BDF0010_01635.jpg,6177,0,6177,DF,070
1095862_DF_070_070BDF0010_01664.jpg,17843,0,17843,DF,070
1095878_DF_070_070BDF0010_01692.jpg,20358,0,20358,DF,070
1095940_DF_070_070BDF0010_01813.jpg,11061,0,11061,DF,070
1096016_DF_070_070BDF0010_01950.jpg,0,1621,1621,DF,070
1096017_DF_070_070BDF0010_01952.jpg,5085,9171,14256,DF,070
1096018_DF_070_070BDF0010_01954.jpg,9340,7737,17077,DF,070
1096028_DF_070_070BDF0010_01972.jpg,5266,0,5266,DF,070
1096057_DF_070_070BDF0010_02023.jpg,2310,1303,3613,DF,070
1096058_DF_070_070BDF0010_02025.jpg,6950,4403,11353,DF,070
1096059_DF_070_070BDF0010_02026.jpg,3517,0,3517,DF,070
1096522_DF_070_070BDF0010_02866.jpg,2003,0,2003,DF,070
1096866_DF_070_070BDF0010_03480.jpg,1926,0,1926,DF,070
1097168_DF_070_070BDF0010_04017.jpg,7054,0,7054,DF,070
1097210_DF_070_070BDF0010_04093.jpg,24,2382,2406,DF,070
1097235_DF_070_070BDF0010_04135.jpg,41,1788,1829,DF,070
1097237_DF_070_070BDF0010_04139.jpg,9126,8421,17547,DF,070
1097246_DF_070_070BDF0010_04154.jpg,28,1753,1781,DF,070
1097247_DF_070_070BDF0010_04156.jpg,1926,3615,5541,DF,070
1097248_DF_070_070BDF0010_04158.jpg,5566,2308,7874,DF,070
1098964_DF_070_070BDF0010_07294.jpg,102,957,1059,DF,070
733835_ES_482_482ES014500_05885.jpg,203,0,203,ES,482
741369_ES_101_101ES000000_00345.jpg,14450,2140,16590,ES,101
765228_ES_259_259ES000000_00240.jpg,2051,0,2051,ES,259
765229_ES_259_259ES000000_00245.jpg,11655,0,11655,ES,259
765235_ES_259_259ES000000_00275.jpg,5078,0,5078,ES,259
765237_ES_259_259ES000000_00285.jpg,1891,0,1891,ES,259
765238_ES_259_259ES000000_00290.jpg,323,0,323,ES,259
765245_ES_259_259ES000000_00325.jpg,605,0,605,ES,259
765272_ES_259_259ES000000_00460.jpg,6861,0,6861,ES,259
765439_ES_259_259ES000000_01295.jpg,1957,0,1957,ES,259
765441_ES_259_259ES000000_01305.jpg,7433,0,7433,ES,259
765442_ES_259_259ES000000_01310.jpg,2204,0,2204,ES,259
765543_ES_259_259ES000000_01815.jpg,7870,0,7870,ES,259
766032_ES_259_259ES000000_04260.jpg,6683,0,6683,ES,259
766116_ES_259_259ES000000_04680.jpg,460,0,460,ES,259
766171_ES_259_259ES000000_04955.jpg,1046,0,1046,ES,259
766172_ES_259_259ES000000_04960.jpg,2608,0,2608,ES,259
773816_ES_259_259ES000000_43180.jpg,958,0,958,ES,259
773818_ES_259_259ES000000_43190.jpg,5575,0,5575,ES,259
773851_ES_259_259ES000000_43355.jpg,778,0,778,ES,259
773854_ES_259_259ES000000_43370.jpg,18,30714,30732,ES,259
774080_ES_259_259ES000000_44500.jpg,737,0,737,ES,259
774082_ES_259_259ES000000_44510.jpg,0,3142,3142,ES,259
774863_ES_259_259ES000000_48415.jpg,1323,0,1323,ES,259
774899_ES_259_259ES000000_48595.jpg,2045,0,2045,ES,259
774900_ES_259_259ES000000_48600.jpg,1952,0,1952,ES,259
819742_ES_259_259ES000000_00195.jpg,23034,0,23034,ES,259
819783_ES_259_259ES000000_00400.jpg,7636,0,7636,ES,259
819784_ES_259_259ES000000_00405.jpg,36577,0,36577,ES,259
819785_ES_259_259ES000000_00410.jpg,35471,0,35471,ES,259
819786_ES_259_259ES000000_00415.jpg,8807,0,8807,ES,259
819787_ES_259_259ES000000_00420.jpg,27636,0,27636,ES,259
819788_ES_259_259ES000000_00425.jpg,22508,0,22508,ES,259
820243_ES_259_259ES000000_02700.jpg,0,5265,5265,ES,259
820316_ES_259_259ES000000_03065.jpg,0,5785,5785,ES,259
883044_RS_290_290RS150131_15951.jpg,0,5692,5692,RS,290
883045_RS_290_290RS150131_15955.jpg,0,11085,11085,RS,290
883046_RS_290_290RS150131_15960.jpg,0,27616,27616,RS,290
883065_RS_290_290RS150131_16055.jpg,4,79196,79200,RS,290
883066_RS_290_290RS150131_16060.jpg,5,110270,110275,RS,290
883068_RS_290_290RS150131_16070.jpg,1,40718,40719,RS,290
883073_RS_290_290RS150131_16095.jpg,0,56047,56047,RS,290
883074_RS_290_290RS150131_16100.jpg,0,31945,31945,RS,290
883075_RS_290_290RS150131_16105.jpg,0,87902,87902,RS,290
883076_RS_290_290RS150131_16110.jpg,0,109558,109558,RS,290
883077_RS_290_290RS150131_16116.jpg,0,73784,73784,RS,290
883078_RS_290_290RS150131_16121.jpg,0,71692,71692,RS,290
883079_RS_290_290RS150131_16125.jpg,0,94966,94966,RS,290
883080_RS_290_290RS150131_16130.jpg,0,142044,142044,RS,290
883081_RS_290_290RS150131_16135.jpg,0,129926,129926,RS,290
883085_RS_290_290RS150131_16155.jpg,5,50464,50469,RS,290
883130_RS_290_290RS150131_16380.jpg,20,27568,27588,RS,290
883131_RS_290_290RS150131_16385.jpg,0,20653,20653,RS,290
883133_RS_290_290RS150131_16395.jpg,0,26212,26212,RS,290
883135_RS_290_290RS150131_16405.jpg,7,8592,8599,RS,290
883139_RS_290_290RS150131_16425.jpg,0,4098,4098,RS,290
883204_RS_290_290RS150131_16750.jpg,0,29972,29972,RS,290
883207_RS_290_290RS150131_16765.jpg,0,2955,2955,RS,290
883216_RS_290_290RS150131_16811.jpg,0,9717,9717,RS,290
883217_RS_290_290RS150131_16815.jpg,0,21996,21996,RS,290
883218_RS_290_290RS150131_16820.jpg,0,4440,4440,RS,290
883232_RS_290_290RS150131_16890.jpg,0,33791,33791,RS,290
883233_RS_290_290RS150131_16895.jpg,2,35854,35856,RS,290
883238_RS_290_290RS150131_16920.jpg,0,17152,17152,RS,290
883239_RS_290_290RS150131_16926.jpg,0,37961,37961,RS,290
883240_RS_290_290RS150131_16930.jpg,0,50769,50769,RS,290
883241_RS_290_290RS150131_16935.jpg,0,61610,61610,RS,290
883243_RS_290_290RS150131_16945.jpg,0,27545,27545,RS,290
883244_RS_290_290RS150131_16950.jpg,0,27107,27107,RS,290
883245_RS_290_290RS150131_16955.jpg,0,41743,41743,RS,290
883246_RS_290_290RS150131_16960.jpg,0,29257,29257,RS,290
883247_RS_290_290RS150131_16965.jpg,0,12150,12150,RS,290
883249_RS_290_290RS150131_16975.jpg,5,23916,23921,RS,290
883252_RS_290_290RS150131_16990.jpg,0,32990,32990,RS,290
883253_RS_290_290RS150131_16996.jpg,0,53967,53967,RS,290
883255_RS_290_290RS150131_17005.jpg,0,35480,35480,RS,290
883256_RS_290_290RS150131_17010.jpg,0,25793,25793,RS,290
883269_RS_290_290RS150131_17075.jpg,0,45883,45883,RS,290
883270_RS_290_290RS150131_17080.jpg,0,67590,67590,RS,290
883271_RS_290_290RS150131_17085.jpg,0,77930,77930,RS,290
883272_RS_290_290RS150131_17090.jpg,0,100904,100904,RS,290
883273_RS_290_290RS150131_17095.jpg,1,49714,49715,RS,290
883274_RS_290_290RS150131_17100.jpg,0,67968,67968,RS,290
883275_RS_290_290RS150131_17105.jpg,1,67604,67605,RS,290
883276_RS_290_290RS150131_17110.jpg,0,17729,17729,RS,290
884076_RS_290_290RS150131_21110.jpg,0,12456,12456,RS,290
884191_RS_290_290RS150131_21685.jpg,0,14588,14588,RS,290
915944_RS_290_290RS294095_13170.jpg,2358,0,2358,RS,290
915945_RS_290_290RS294095_13175.jpg,6355,0,6355,RS,290
915946_RS_290_290RS294095_13181.jpg,5746,0,5746,RS,290
915947_RS_290_290RS294095_13185.jpg,3170,0,3170,RS,290
915957_RS_290_290RS294095_13235.jpg,4329,0,4329,RS,290
915958_RS_290_290RS294095_13241.jpg,7974,0,7974,RS,290
915959_RS_290_290RS294095_13245.jpg,4541,0,4541,RS,290
915960_RS_290_290RS294095_13250.jpg,5486,0,5486,RS,290
915961_RS_290_290RS294095_13255.jpg,3772,0,3772,RS,290
915964_RS_290_290RS294095_13270.jpg,2527,0,2527,RS,290
915965_RS_290_290RS294095_13275.jpg,9518,0,9518,RS,290
915966_RS_290_290RS294095_13280.jpg,4125,0,4125,RS,290
915968_RS_290_290RS294095_13290.jpg,1631,0,1631,RS,290
915985_RS_290_290RS294095_13376.jpg,2848,0,2848,RS,290
916002_RS_290_290RS294095_13460.jpg,81,1324,1405,RS,290
916024_RS_290_290RS294095_13570.jpg,9478,0,9478,RS,290
916079_RS_290_290RS294095_13846.jpg,2333,0,2333,RS,290
916109_RS_290_290RS294095_13996.jpg,148,1313,1461,RS,290
916111_RS_290_290RS294095_14005.jpg,12234,10087,22321,RS,290
916113_RS_290_290RS294095_14015.jpg,26922,0,26922,RS,290
916114_RS_290_290RS294095_14020.jpg,17191,0,17191,RS,290
916117_RS_290_290RS294095_14035.jpg,5008,0,5008,RS,290
916118_RS_290_290RS294095_14040.jpg,21636,0,21636,RS,290
916119_RS_290_290RS294095_14045.jpg,5233,0,5233,RS,290
916134_RS_290_290RS294095_14120.jpg,510,0,510,RS,290
916151_RS_290_290RS294095_14205.jpg,978,0,978,RS,290
916152_RS_290_290RS294095_14210.jpg,994,0,994,RS,290
916162_RS_290_290RS294095_14260.jpg,2135,0,2135,RS,290
916304_RS_290_290RS294095_14970.jpg,330,0,330,RS,290
916335_RS_290_290RS294095_15126.jpg,27,892,919,RS,290
916336_RS_290_290RS294095_15130.jpg,108,2949,3057,RS,290
916337_RS_290_290RS294095_15137.jpg,7849,0,7849,RS,290
916338_RS_290_290RS294095_15140.jpg,829,0,829,RS,290
916434_RS_290_290RS294095_15621.jpg,903,0,903,RS,290
916435_RS_290_290RS294095_15626.jpg,5608,0,5608,RS,290
916436_RS_290_290RS294095_15630.jpg,5562,0,5562,RS,290
916438_RS_290_290RS294095_15640.jpg,1466,0,1466,RS,290
916611_RS_290_290RS294095_16505.jpg,55,1209,1264,RS,290
916639_RS_290_290RS294095_16645.jpg,11709,0,11709,RS,290
916643_RS_290_290RS294095_16665.jpg,10481,0,10481,RS,290
916644_RS_290_290RS294095_16670.jpg,14179,0,14179,RS,290
916646_RS_290_290RS294095_16680.jpg,7193,0,7193,RS,290
916647_RS_290_290RS294095_16685.jpg,10854,0,10854,RS,290
916648_RS_290_290RS294095_16690.jpg,12434,0,12434,RS,290
916652_RS_290_290RS294095_16711.jpg,8738,1164,9902,RS,290
916653_RS_290_290RS294095_16715.jpg,6414,3611,10025,RS,290
916655_RS_290_290RS294095_16725.jpg,8536,0,8536,RS,290
916659_RS_290_290RS294095_16745.jpg,10911,0,10911,RS,290
916665_RS_290_290RS294095_16775.jpg,3942,2308,6250,RS,290
916682_RS_290_290RS294095_16860.jpg,39,13416,13455,RS,290
916683_RS_290_290RS294095_16865.jpg,9481,3425,12906,RS,290
916868_RS_290_290RS294095_17790.jpg,5100,0,5100,RS,290
916869_RS_290_290RS294095_17795.jpg,4282,0,4282,RS,290
916871_RS_290_290RS294095_17806.jpg,13715,10612,24327,RS,290
916872_RS_290_290RS294095_17810.jpg,20335,11467,31802,RS,290
916873_RS_290_290RS294095_17815.jpg,5709,3542,9251,RS,290
916875_RS_290_290RS294095_17825.jpg,121,24503,24624,RS,290
916876_RS_290_290RS294095_17830.jpg,153,3361,3514,RS,290
916877_RS_290_290RS294095_17835.jpg,49,10774,10823,RS,290
916878_RS_290_290RS294095_17840.jpg,28,33474,33502,RS,290
916879_RS_290_290RS294095_17845.jpg,46,1096,1142,RS,290
916886_RS_290_290RS294095_17880.jpg,153,2778,2931,RS,290
916888_RS_290_290RS294095_17890.jpg,87,11236,11323,RS,290
916891_RS_290_290RS294095_17905.jpg,48,2188,2236,RS,290
916892_RS_290_290RS294095_17910.jpg,4680,3775,8455,RS,290
916922_RS_290_290RS294095_18061.jpg,16194,5343,21537,RS,290
916938_RS_290_290RS294095_18140.jpg,888,760,1648,RS,290
916939_RS_290_290RS294095_18145.jpg,3268,2588,5856,RS,290
916949_RS_290_290RS294095_18195.jpg,1321,1258,2579,RS,290
916950_RS_290_290RS294095_18200.jpg,2159,4109,6268,RS,290
916994_RS_290_290RS294095_18420.jpg,134,1853,1987,RS,290
917025_RS_290_290RS294095_18576.jpg,2174,0,2174,RS,290
917038_RS_290_290RS294095_18640.jpg,0,904,904,RS,290
917042_RS_290_290RS294095_18660.jpg,1748,9809,11557,RS,290
917043_RS_290_290RS294095_18665.jpg,4634,32199,36833,RS,290
917044_RS_290_290RS294095_18670.jpg,38,1518,1556,RS,290
917045_RS_290_290RS294095_18675.jpg,0,1782,1782,RS,290
917064_RS_290_290RS294095_18770.jpg,1296,0,1296,RS,290
917066_RS_290_290RS294095_18780.jpg,5,2372,2377,RS,290
917067_RS_290_290RS294095_18785.jpg,1051,1835,2886,RS,290
917069_RS_290_290RS294095_18795.jpg,1976,0,1976,RS,290
917070_RS_290_290RS294095_18800.jpg,10988,0,10988,RS,290
917071_RS_290_290RS294095_18805.jpg,15502,0,15502,RS,290
917072_RS_290_290RS294095_18810.jpg,1738,0,1738,RS,290
917087_RS_290_290RS294095_18885.jpg,15634,0,15634,RS,290
917088_RS_290_290RS294095_18890.jpg,19165,0,19165,RS,290
917090_RS_290_290RS294095_18900.jpg,1040,0,1040,RS,290
917091_RS_290_290RS294095_18905.jpg,4522,0,4522,RS,290
917092_RS_290_290RS294095_18910.jpg,10709,0,10709,RS,290
917093_RS_290_290RS294095_18915.jpg,13879,0,13879,RS,290
917094_RS_290_290RS294095_18920.jpg,16470,0,16470,RS,290
917095_RS_290_290RS294095_18925.jpg,12475,0,12475,RS,290
917096_RS_290_290RS294095_18930.jpg,12314,0,12314,RS,290
917097_RS_290_290RS294095_18935.jpg,7846,0,7846,RS,290
917104_RS_290_290RS294095_18970.jpg,10518,0,10518,RS,290
917105_RS_290_290RS294095_18975.jpg,9438,0,9438,RS,290
917108_RS_290_290RS294095_18990.jpg,889,2605,3494,RS,290
917109_RS_290_290RS294095_18995.jpg,2591,6223,8814,RS,290
917113_RS_290_290RS294095_19015.jpg,9579,0,9579,RS,290
917114_RS_290_290RS294095_19020.jpg,15590,0,15590,RS,290
917115_RS_290_290RS294095_19025.jpg,14650,0,14650,RS,290
917116_RS_290_290RS294095_19030.jpg,20000,7455,27455,RS,290
917117_RS_290_290RS294095_19035.jpg,2851,0,2851,RS,290
917119_RS_290_290RS294095_19045.jpg,3072,0,3072,RS,290
917120_RS_290_290RS294095_19051.jpg,18111,0,18111,RS,290
917121_RS_290_290RS294095_19055.jpg,11294,0,11294,RS,290
917129_RS_290_290RS294095_19096.jpg,7647,0,7647,RS,290
917131_RS_290_290RS294095_19105.jpg,14530,0,14530,RS,290
917155_RS_290_290RS294095_19225.jpg,14035,0,14035,RS,290
917161_RS_290_290RS294095_19255.jpg,8169,0,8169,RS,290
917162_RS_290_290RS294095_19261.jpg,16384,0,16384,RS,290
917170_RS_290_290RS294095_19300.jpg,10084,0,10084,RS,290
917171_RS_290_290RS294095_19305.jpg,6564,0,6564,RS,290
917186_RS_290_290RS294095_19380.jpg,10403,1734,12137,RS,290
917187_RS_290_290RS294095_19385.jpg,67467,0,67467,RS,290
917188_RS_290_290RS294095_19390.jpg,32351,0,32351,RS,290
917189_RS_290_290RS294095_19395.jpg,7834,0,7834,RS,290
917190_RS_290_290RS294095_19400.jpg,10931,0,10931,RS,290
917191_RS_290_290RS294095_19405.jpg,3954,0,3954,RS,290
917192_RS_290_290RS294095_19410.jpg,4646,0,4646,RS,290
917193_RS_290_290RS294095_19415.jpg,9025,0,9025,RS,290
917195_RS_290_290RS294095_19426.jpg,7813,0,7813,RS,290
917197_RS_290_290RS294095_19435.jpg,13944,0,13944,RS,290
917198_RS_290_290RS294095_19440.jpg,19117,0,19117,RS,290
917199_RS_290_290RS294095_19445.jpg,10685,0,10685,RS,290
917200_RS_290_290RS294095_19450.jpg,10070,0,10070,RS,290
917201_RS_290_290RS294095_19455.jpg,6146,0,6146,RS,290
917202_RS_290_290RS294095_19460.jpg,23112,0,23112,RS,290
917203_RS_290_290RS294095_19465.jpg,54571,0,54571,RS,290
917204_RS_290_290RS294095_19470.jpg,52681,2167,54848,RS,290
917206_RS_290_290RS294095_19480.jpg,18397,0,18397,RS,290
917207_RS_290_290RS294095_19485.jpg,3035,0,3035,RS,290
917208_RS_290_290RS294095_19490.jpg,11681,0,11681,RS,290
917211_RS_290_290RS294095_19505.jpg,15696,0,15696,RS,290
917212_RS_290_290RS294095_19510.jpg,16409,0,16409,RS,290
917215_RS_290_290RS294095_19525.jpg,17910,2941,20851,RS,290
917216_RS_290_290RS294095_19530.jpg,22256,1287,23543,RS,290
917217_RS_290_290RS294095_19535.jpg,24779,0,24779,RS,290
917219_RS_290_290RS294095_19545.jpg,24822,0,24822,RS,290
917220_RS_290_290RS294095_19551.jpg,13672,0,13672,RS,290
917221_RS_290_290RS294095_19555.jpg,10848,0,10848,RS,290
917222_RS_290_290RS294095_19560.jpg,5707,0,5707,RS,290
917223_RS_290_290RS294095_19565.jpg,6800,0,6800,RS,290
917224_RS_290_290RS294095_19570.jpg,12589,0,12589,RS,290
917225_RS_290_290RS294095_19575.jpg,12807,0,12807,RS,290
917226_RS_290_290RS294095_19580.jpg,13275,0,13275,RS,290
917228_RS_290_290RS294095_19590.jpg,13543,0,13543,RS,290
917230_RS_290_290RS294095_19600.jpg,11303,0,11303,RS,290
917231_RS_290_290RS294095_19605.jpg,16087,0,16087,RS,290
917232_RS_290_290RS294095_19613.jpg,26091,0,26091,RS,290
917233_RS_290_290RS294095_19615.jpg,26091,0,26091,RS,290
917234_RS_290_290RS294095_19620.jpg,26723,0,26723,RS,290
917236_RS_290_290RS294095_19630.jpg,26491,0,26491,RS,290
917237_RS_290_290RS294095_19635.jpg,16189,0,16189,RS,290
917238_RS_290_290RS294095_19640.jpg,8603,0,8603,RS,290
917239_RS_290_290RS294095_19646.jpg,8586,0,8586,RS,290
917240_RS_290_290RS294095_19650.jpg,16807,0,16807,RS,290
917241_RS_290_290RS294095_19655.jpg,24835,0,24835,RS,290
917243_RS_290_290RS294095_19665.jpg,6912,0,6912,RS,290
917244_RS_290_290RS294095_19670.jpg,4491,0,4491,RS,290
917245_RS_290_290RS294095_19675.jpg,5979,0,5979,RS,290
917246_RS_290_290RS294095_19680.jpg,12973,0,12973,RS,290
917247_RS_290_290RS294095_19685.jpg,37184,0,37184,RS,290
917249_RS_290_290RS294095_19695.jpg,40735,0,40735,RS,290
917250_RS_290_290RS294095_19700.jpg,44196,0,44196,RS,290
917251_RS_290_290RS294095_19705.jpg,74465,0,74465,RS,290
917252_RS_290_290RS294095_19710.jpg,55178,0,55178,RS,290
917253_RS_290_290RS294095_19715.jpg,47279,0,47279,RS,290
917254_RS_290_290RS294095_19721.jpg,23879,0,23879,RS,290
917255_RS_290_290RS294095_19725.jpg,26903,0,26903,RS,290
917256_RS_290_290RS294095_19730.jpg,26678,0,26678,RS,290
917257_RS_290_290RS294095_19736.jpg,1831,0,1831,RS,290
917259_RS_290_290RS294095_19745.jpg,21615,0,21615,RS,290
917268_RS_290_290RS294095_19790.jpg,21894,0,21894,RS,290
917269_RS_290_290RS294095_19795.jpg,22473,0,22473,RS,290
917272_RS_290_290RS294095_19810.jpg,12442,0,12442,RS,290
917273_RS_290_290RS294095_19816.jpg,30743,0,30743,RS,290
917279_RS_290_290RS294095_19845.jpg,15415,0,15415,RS,290
917280_RS_290_290RS294095_19850.jpg,26425,0,26425,RS,290
917281_RS_290_290RS294095_19855.jpg,12094,51,12145,RS,290
917282_RS_290_290RS294095_19860.jpg,5863,0,5863,RS,290
917283_RS_290_290RS294095_19866.jpg,2874,0,2874,RS,290
917284_RS_290_290RS294095_19871.jpg,4250,0,4250,RS,290
917285_RS_290_290RS294095_19875.jpg,3159,6,3165,RS,290
917286_RS_290_290RS294095_19880.jpg,5013,3600,8613,RS,290
917287_RS_290_290RS294095_19885.jpg,8767,0,8767,RS,290
917289_RS_290_290RS294095_19895.jpg,9835,0,9835,RS,290
917290_RS_290_290RS294095_19900.jpg,2490,0,2490,RS,290
917292_RS_290_290RS294095_19910.jpg,15633,0,15633,RS,290
917293_RS_290_290RS294095_19915.jpg,21982,0,21982,RS,290
917294_RS_290_290RS294095_19920.jpg,6780,0,6780,RS,290
917295_RS_290_290RS294095_19925.jpg,9549,0,9549,RS,290
917296_RS_290_290RS294095_19930.jpg,3547,0,3547,RS,290
917297_RS_290_290RS294095_19935.jpg,2185,0,2185,RS,290
917307_RS_290_290RS294095_19987.jpg,5457,0,5457,RS,290
917311_RS_290_290RS294095_20005.jpg,4564,1742,6306,RS,290
917312_RS_290_290RS294095_20010.jpg,2418,4731,7149,RS,290
917324_RS_290_290RS294095_20070.jpg,5080,0,5080,RS,290
917325_RS_290_290RS294095_20075.jpg,12401,0,12401,RS,290
917327_RS_290_290RS294095_20085.jpg,3608,0,3608,RS,290
917336_RS_290_290RS294095_20131.jpg,12013,0,12013,RS,290
917337_RS_290_290RS294095_20135.jpg,12195,0,12195,RS,290
917350_RS_290_290RS294095_20200.jpg,2948,0,2948,RS,290
917364_RS_290_290RS294095_20270.jpg,1464,0,1464,RS,290
917375_RS_290_290RS294095_20325.jpg,4023,0,4023,RS,290
917379_RS_290_290RS294095_20345.jpg,12831,0,12831,RS,290
917380_RS_290_290RS294095_20350.jpg,9273,0,9273,RS,290
917381_RS_290_290RS294095_20355.jpg,3336,0,3336,RS,290
917389_RS_290_290RS294095_20395.jpg,13527,0,13527,RS,290
917390_RS_290_290RS294095_20400.jpg,4809,0,4809,RS,290
917391_RS_290_290RS294095_20405.jpg,7076,0,7076,RS,290
917397_RS_290_290RS294095_20435.jpg,29024,0,29024,RS,290
917402_RS_290_290RS294095_20460.jpg,14995,0,14995,RS,290
917403_RS_290_290RS294095_20465.jpg,25666,0,25666,RS,290
917415_RS_290_290RS294095_20525.jpg,33001,0,33001,RS,290
917425_RS_290_290RS294095_20576.jpg,0,5380,5380,RS,290
917426_RS_290_290RS294095_20580.jpg,15,8200,8215,RS,290
917427_RS_290_290RS294095_20585.jpg,94,48828,48922,RS,290
917440_RS_290_290RS294095_20650.jpg,21463,0,21463,RS,290
917442_RS_290_290RS294095_20660.jpg,8056,0,8056,RS,290
917448_RS_290_290RS294095_20691.jpg,20360,0,20360,RS,290
917454_RS_290_290RS294095_20720.jpg,2903,0,2903,RS,290
917455_RS_290_290RS294095_20725.jpg,2079,0,2079,RS,290
917460_RS_290_290RS294095_20750.jpg,1153,0,1153,RS,290
917461_RS_290_290RS294095_20755.jpg,6089,0,6089,RS,290
917466_RS_290_290RS294095_20780.jpg,4273,0,4273,RS,290
917467_RS_290_290RS294095_20785.jpg,8902,0,8902,RS,290
917470_RS_290_290RS294095_20800.jpg,14906,0,14906,RS,290
917471_RS_290_290RS294095_20805.jpg,9004,0,9004,RS,290
917481_RS_290_290RS294095_20856.jpg,8356,0,8356,RS,290
917482_RS_290_290RS294095_20860.jpg,8451,0,8451,RS,290
917489_RS_290_290RS294095_20895.jpg,1680,1731,3411,RS,290
917490_RS_290_290RS294095_20900.jpg,3461,5205,8666,RS,290
917494_RS_290_290RS294095_20920.jpg,1105,0,1105,RS,290
917503_RS_290_290RS294095_20965.jpg,17,1301,1318,RS,290
917517_RS_290_290RS294095_21035.jpg,5583,0,5583,RS,290
917518_RS_290_290RS294095_21040.jpg,1794,0,1794,RS,290
917529_RS_290_290RS294095_21095.jpg,9756,0,9756,RS,290
917530_RS_290_290RS294095_21100.jpg,39528,0,39528,RS,290
917542_RS_290_290RS294095_21160.jpg,5425,907,6332,RS,290
917543_RS_290_290RS294095_21165.jpg,8763,2684,11447,RS,290
917556_RS_290_290RS294095_21230.jpg,2936,0,2936,RS,290
917558_RS_290_290RS294095_21240.jpg,6045,0,6045,RS,290
917563_RS_290_290RS294095_21265.jpg,580,0,580,RS,290
917564_RS_290_290RS294095_21270.jpg,2419,0,2419,RS,290
917566_RS_290_290RS294095_21280.jpg,7135,0,7135,RS,290
917567_RS_290_290RS294095_21285.jpg,16704,0,16704,RS,290
917568_RS_290_290RS294095_21290.jpg,16591,0,16591,RS,290
917570_RS_290_290RS294095_21300.jpg,33973,0,33973,RS,290
917571_RS_290_290RS294095_21305.jpg,23552,0,23552,RS,290
917572_RS_290_290RS294095_21310.jpg,2937,0,2937,RS,290
917577_RS_290_290RS294095_21335.jpg,7181,0,7181,RS,290
917579_RS_290_290RS294095_21345.jpg,9527,0,9527,RS,290
917620_RS_290_290RS294095_21550.jpg,25,3041,3066,RS,290
917622_RS_290_290RS294095_21560.jpg,0,3368,3368,RS,290
917670_RS_290_290RS294095_21800.jpg,33,5760,5793,RS,290
917671_RS_290_290RS294095_21805.jpg,148,9022,9170,RS,290
917699_RS_290_290RS294095_21945.jpg,12,5928,5940,RS,290
917700_RS_290_290RS294095_21950.jpg,33,19177,19210,RS,290
917724_RS_290_290RS294095_22070.jpg,1328,673,2001,RS,290
917766_RS_290_290RS294095_22280.jpg,9087,0,9087,RS,290
917772_RS_290_290RS294095_22312.jpg,11807,0,11807,RS,290
917788_RS_290_290RS294095_22390.jpg,2782,0,2782,RS,290
917803_RS_290_290RS294095_22466.jpg,10846,0,10846,RS,290
917804_RS_290_290RS294095_22470.jpg,12084,0,12084,RS,290
917805_RS_290_290RS294095_22475.jpg,4035,0,4035,RS,290
917819_RS_290_290RS294095_22545.jpg,6048,0,6048,RS,290
917820_RS_290_290RS294095_22550.jpg,10712,0,10712,RS,290
917821_RS_290_290RS294095_22555.jpg,8481,0,8481,RS,290
917838_RS_290_290RS294095_22640.jpg,4414,0,4414,RS,290
917853_RS_290_290RS294095_22715.jpg,5046,0,5046,RS,290
917854_RS_290_290RS294095_22720.jpg,8721,0,8721,RS,290
917872_RS_290_290RS294095_22810.jpg,4075,0,4075,RS,290
917873_RS_290_290RS294095_22815.jpg,4978,0,4978,RS,290
917874_RS_290_290RS294095_22820.jpg,3394,0,3394,RS,290
917886_RS_290_290RS294095_22880.jpg,4978,0,4978,RS,290
917892_RS_290_290RS294095_22910.jpg,6175,0,6175,RS,290
917893_RS_290_290RS294095_22915.jpg,5814,0,5814,RS,290
917900_RS_290_290RS294095_22950.jpg,5528,0,5528,RS,290
917901_RS_290_290RS294095_22955.jpg,12493,0,12493,RS,290
917902_RS_290_290RS294095_22960.jpg,10408,0,10408,RS,290
917903_RS_290_290RS294095_22965.jpg,11014,0,11014,RS,290
917906_RS_290_290RS294095_22980.jpg,7567,0,7567,RS,290
917907_RS_290_290RS294095_22986.jpg,2748,0,2748,RS,290
917908_RS_290_290RS294095_22990.jpg,3694,0,3694,RS,290
917909_RS_290_290RS294095_22995.jpg,2672,0,2672,RS,290
917910_RS_290_290RS294095_23000.jpg,1972,0,1972,RS,290
917926_RS_290_290RS294095_23080.jpg,1125,0,1125,RS,290
917927_RS_290_290RS294095_23085.jpg,1816,0,1816,RS,290
917930_RS_290_290RS294095_23100.jpg,1115,0,1115,RS,290
917937_RS_290_290RS294095_23135.jpg,1678,0,1678,RS,290
917938_RS_290_290RS294095_23140.jpg,1263,0,1263,RS,290
917943_RS_290_290RS294095_23165.jpg,2371,0,2371,RS,290
917944_RS_290_290RS294095_23170.jpg,7781,0,7781,RS,290
917945_RS_290_290RS294095_23175.jpg,2417,0,2417,RS,290
917948_RS_290_290RS294095_23190.jpg,17431,0,17431,RS,290
917958_RS_290_290RS294095_23240.jpg,15163,0,15163,RS,290
917960_RS_290_290RS294095_23250.jpg,12997,0,12997,RS,290
917961_RS_290_290RS294095_23255.jpg,16924,0,16924,RS,290
918042_RS_290_290RS294095_23660.jpg,436,2832,3268,RS,290
918058_RS_290_290RS294095_23740.jpg,5457,0,5457,RS,290
918101_RS_290_290RS294095_23956.jpg,1304,0,1304,RS,290
918127_RS_290_290RS294095_24085.jpg,4668,0,4668,RS,290
918128_RS_290_290RS294095_24091.jpg,6022,0,6022,RS,290
918129_RS_290_290RS294095_24095.jpg,6708,0,6708,RS,290
918213_RS_290_290RS294095_24515.jpg,4511,0,4511,RS,290
918214_RS_290_290RS294095_24520.jpg,3749,0,3749,RS,290
918219_RS_290_290RS294095_24545.jpg,2980,0,2980,RS,290
918220_RS_290_290RS294095_24551.jpg,12757,0,12757,RS,290
918230_RS_290_290RS294095_24600.jpg,10852,0,10852,RS,290
918231_RS_290_290RS294095_24605.jpg,7988,0,7988,RS,290
918234_RS_290_290RS294095_24620.jpg,11450,0,11450,RS,290
918235_RS_290_290RS294095_24625.jpg,9125,0,9125,RS,290
918236_RS_290_290RS294095_24630.jpg,6233,0,6233,RS,290
918237_RS_290_290RS294095_24635.jpg,6774,0,6774,RS,290
918240_RS_290_290RS294095_24650.jpg,7647,0,7647,RS,290
918355_RS_290_290RS294095_25225.jpg,3788,0,3788,RS,290
918356_RS_290_290RS294095_25230.jpg,3636,0,3636,RS,290
918373_RS_290_290RS294095_25315.jpg,16849,0,16849,RS,290
918374_RS_290_290RS294095_25320.jpg,3875,0,3875,RS,290
918383_RS_290_290RS294095_25365.jpg,1117,0,1117,RS,290
918386_RS_290_290RS294095_25380.jpg,5602,0,5602,RS,290
918387_RS_290_290RS294095_25385.jpg,8678,0,8678,RS,290
918388_RS_290_290RS294095_25390.jpg,14046,0,14046,RS,290
918389_RS_290_290RS294095_25395.jpg,4738,0,4738,RS,290
918396_RS_290_290RS294095_25430.jpg,2790,0,2790,RS,290
918403_RS_290_290RS294095_25465.jpg,9839,0,9839,RS,290
918405_RS_290_290RS294095_25475.jpg,3227,0,3227,RS,290
918467_RS_290_290RS294095_25785.jpg,1982,0,1982,RS,290
918483_RS_290_290RS294095_25865.jpg,2619,0,2619,RS,290
918515_RS_290_290RS294095_26026.jpg,967,0,967,RS,290
918532_RS_290_290RS294095_26110.jpg,7164,0,7164,RS,290
918923_RS_290_290RS294095_28065.jpg,9479,0,9479,RS,290
918939_RS_290_290RS294095_28145.jpg,1440,0,1440,RS,290
918958_RS_290_290RS294095_28240.jpg,5082,0,5082,RS,290
918959_RS_290_290RS294095_28245.jpg,3589,0,3589,RS,290
918976_RS_290_290RS294095_28330.jpg,2314,0,2314,RS,290
918993_RS_290_290RS294095_28415.jpg,14257,0,14257,RS,290
918994_RS_290_290RS294095_28420.jpg,17604,0,17604,RS,290
918996_RS_290_290RS294095_28430.jpg,2933,0,2933,RS,290
919012_RS_290_290RS294095_28510.jpg,1321,0,1321,RS,290
919090_RS_290_290RS294095_28900.jpg,2742,0,2742,RS,290
919101_RS_290_290RS294095_28955.jpg,8353,0,8353,RS,290
919106_RS_290_290RS294095_28980.jpg,4061,0,4061,RS,290
919137_RS_290_290RS294095_29135.jpg,6720,0,6720,RS,290
919138_RS_290_290RS294095_29140.jpg,2706,0,2706,RS,290
919139_RS_290_290RS294095_29145.jpg,9257,0,9257,RS,290
919141_RS_290_290RS294095_29155.jpg,7082,0,7082,RS,290
919142_RS_290_290RS294095_29160.jpg,4155,0,4155,RS,290
919143_RS_290_290RS294095_29165.jpg,16338,0,16338,RS,290
919144_RS_290_290RS294095_29170.jpg,4522,0,4522,RS,290
919149_RS_290_290RS294095_29196.jpg,13651,0,13651,RS,290
919150_RS_290_290RS294095_29201.jpg,7706,0,7706,RS,290
919151_RS_290_290RS294095_29205.jpg,1504,0,1504,RS,290
919153_RS_290_290RS294095_29215.jpg,4092,0,4092,RS,290
919154_RS_290_290RS294095_29220.jpg,15863,0,15863,RS,290
919159_RS_290_290RS294095_29245.jpg,11365,0,11365,RS,290
919165_RS_290_290RS294095_29275.jpg,6547,0,6547,RS,290
919166_RS_290_290RS294095_29280.jpg,8165,0,8165,RS,290
919168_RS_290_290RS294095_29290.jpg,16839,0,16839,RS,290
919182_RS_290_290RS294095_29360.jpg,4656,0,4656,RS,290
919183_RS_290_290RS294095_29365.jpg,10183,0,10183,RS,290
919184_RS_290_290RS294095_29370.jpg,12449,0,12449,RS,290
919185_RS_290_290RS294095_29375.jpg,12773,0,12773,RS,290
919188_RS_290_290RS294095_29390.jpg,6802,0,6802,RS,290
919195_RS_290_290RS294095_29425.jpg,17340,0,17340,RS,290
919203_RS_290_290RS294095_29465.jpg,10776,0,10776,RS,290
919204_RS_290_290RS294095_29470.jpg,4708,0,4708,RS,290
919208_RS_290_290RS294095_29490.jpg,29372,0,29372,RS,290
919209_RS_290_290RS294095_29495.jpg,9638,0,9638,RS,290
919210_RS_290_290RS294095_29500.jpg,10069,0,10069,RS,290
919240_RS_290_290RS294095_29650.jpg,9056,0,9056,RS,290
919241_RS_290_290RS294095_29655.jpg,12685,0,12685,RS,290
919249_RS_290_290RS294095_29695.jpg,3173,0,3173,RS,290
919252_RS_290_290RS294095_29711.jpg,10801,932,11733,RS,290
919253_RS_290_290RS294095_29715.jpg,9330,2452,11782,RS,290
919262_RS_290_290RS294095_29760.jpg,0,562,562,RS,290
919263_RS_290_290RS294095_29766.jpg,96,1156,1252,RS,290
919264_RS_290_290RS294095_29770.jpg,9765,3191,12956,RS,290
919265_RS_290_290RS294095_29776.jpg,10516,0,10516,RS,290
919268_RS_290_290RS294095_29790.jpg,16194,0,16194,RS,290
919274_RS_290_290RS294095_29820.jpg,12652,0,12652,RS,290
919277_RS_290_290RS294095_29836.jpg,8451,0,8451,RS,290
919287_RS_290_290RS294095_29885.jpg,4282,0,4282,RS,290
919289_RS_290_290RS294095_29895.jpg,12068,0,12068,RS,290
919290_RS_290_290RS294095_29900.jpg,18502,0,18502,RS,290
919293_RS_290_290RS294095_29915.jpg,14152,0,14152,RS,290
919294_RS_290_290RS294095_29920.jpg,16029,0,16029,RS,290
919350_RS_290_290RS294095_30200.jpg,1198,3179,4377,RS,290
919356_RS_290_290RS294095_30230.jpg,7877,0,7877,RS,290
919357_RS_290_290RS294095_30235.jpg,655,0,655,RS,290
919374_RS_290_290RS294095_30320.jpg,2266,0,2266,RS,290
919399_RS_290_290RS294095_30445.jpg,12462,0,12462,RS,290
919412_RS_290_290RS294095_30511.jpg,4351,0,4351,RS,290
919454_RS_290_290RS294095_30720.jpg,2519,0,2519,RS,290
919470_RS_290_290RS294095_30800.jpg,2081,0,2081,RS,290
919474_RS_290_290RS294095_30820.jpg,820,0,820,RS,290
919481_RS_290_290RS294095_30855.jpg,1063,0,1063,RS,290
919488_RS_290_290RS294095_30891.jpg,578,4239,4817,RS,290
919492_RS_290_290RS294095_30910.jpg,1047,2162,3209,RS,290
919493_RS_290_290RS294095_30915.jpg,1270,0,1270,RS,290
919523_RS_290_290RS294095_31066.jpg,14529,0,14529,RS,290
919524_RS_290_290RS294095_31070.jpg,19515,0,19515,RS,290
919525_RS_290_290RS294095_31075.jpg,41268,0,41268,RS,290
919526_RS_290_290RS294095_31080.jpg,17389,0,17389,RS,290
919527_RS_290_290RS294095_31085.jpg,6777,0,6777,RS,290
919528_RS_290_290RS294095_31091.jpg,6180,0,6180,RS,290
919529_RS_290_290RS294095_31095.jpg,7123,0,7123,RS,290
919530_RS_290_290RS294095_31101.jpg,29310,0,29310,RS,290
919531_RS_290_290RS294095_31105.jpg,35723,0,35723,RS,290
919532_RS_290_290RS294095_31110.jpg,16899,0,16899,RS,290
919533_RS_290_290RS294095_31115.jpg,1676,0,1676,RS,290
919534_RS_290_290RS294095_31120.jpg,7094,0,7094,RS,290
919535_RS_290_290RS294095_31125.jpg,2700,0,2700,RS,290
919545_RS_290_290RS294095_31175.jpg,11417,0,11417,RS,290
919546_RS_290_290RS294095_31180.jpg,30491,0,30491,RS,290
919547_RS_290_290RS294095_31185.jpg,23991,0,23991,RS,290
919553_RS_290_290RS294095_31216.jpg,1912,0,1912,RS,290
919558_RS_290_290RS294095_31240.jpg,2817,0,2817,RS,290
919559_RS_290_290RS294095_31245.jpg,11609,1227,12836,RS,290
919560_RS_290_290RS294095_31250.jpg,65405,358,65763,RS,290
919561_RS_290_290RS294095_31255.jpg,28354,0,28354,RS,290
919563_RS_290_290RS294095_31266.jpg,38016,0,38016,RS,290
919564_RS_290_290RS294095_31271.jpg,23911,0,23911,RS,290
919565_RS_290_290RS294095_31275.jpg,19612,0,19612,RS,290
919566_RS_290_290RS294095_31281.jpg,20904,0,20904,RS,290
919567_RS_290_290RS294095_31286.jpg,19246,0,19246,RS,290
919630_RS_290_290RS294095_31600.jpg,33470,0,33470,RS,290
919634_RS_290_290RS294095_31621.jpg,7001,0,7001,RS,290
919702_RS_290_290RS294095_31960.jpg,4165,0,4165,RS,290
919704_RS_290_290RS294095_31970.jpg,2667,0,2667,RS,290
919718_RS_290_290RS294095_32040.jpg,2594,0,2594,RS,290
919722_RS_290_290RS294095_32060.jpg,22582,0,22582,RS,290
919723_RS_290_290RS294095_32066.jpg,27879,0,27879,RS,290
919729_RS_290_290RS294095_32095.jpg,11762,0,11762,RS,290
919730_RS_290_290RS294095_32100.jpg,19547,0,19547,RS,290
919737_RS_290_290RS294095_32135.jpg,5820,0,5820,RS,290
919738_RS_290_290RS294095_32140.jpg,6223,0,6223,RS,290
919739_RS_290_290RS294095_32145.jpg,9620,0,9620,RS,290
919740_RS_290_290RS294095_32150.jpg,11084,0,11084,RS,290
919743_RS_290_290RS294095_32165.jpg,16182,0,16182,RS,290
919744_RS_290_290RS294095_32170.jpg,2084,0,2084,RS,290
919755_RS_290_290RS294095_32225.jpg,11868,0,11868,RS,290
919756_RS_290_290RS294095_32230.jpg,25527,0,25527,RS,290
919757_RS_290_290RS294095_32235.jpg,20557,0,20557,RS,290
919761_RS_290_290RS294095_32255.jpg,12281,0,12281,RS,290
919764_RS_290_290RS294095_32270.jpg,4404,0,4404,RS,290
919768_RS_290_290RS294095_32290.jpg,8120,0,8120,RS,290
919770_RS_290_290RS294095_32300.jpg,17654,0,17654,RS,290
919771_RS_290_290RS294095_32305.jpg,16669,0,16669,RS,290
919773_RS_290_290RS294095_32315.jpg,6787,0,6787,RS,290
919774_RS_290_290RS294095_32320.jpg,12392,0,12392,RS,290
919775_RS_290_290RS294095_32325.jpg,30091,0,30091,RS,290
919776_RS_290_290RS294095_32330.jpg,22515,0,22515,RS,290
919777_RS_290_290RS294095_32335.jpg,13475,0,13475,RS,290
919778_RS_290_290RS294095_32340.jpg,16639,0,16639,RS,290
919779_RS_290_290RS294095_32345.jpg,22117,0,22117,RS,290
919788_RS_290_290RS294095_32390.jpg,11842,0,11842,RS,290
919789_RS_290_290RS294095_32395.jpg,16190,0,16190,RS,290
919791_RS_290_290RS294095_32405.jpg,18979,0,18979,RS,290
919794_RS_290_290RS294095_32420.jpg,5780,0,5780,RS,290
919806_RS_290_290RS294095_32481.jpg,14119,0,14119,RS,290
919808_RS_290_290RS294095_32490.jpg,7600,838,8438,RS,290
919809_RS_290_290RS294095_32495.jpg,6636,0,6636,RS,290
919823_RS_290_290RS294095_32565.jpg,8129,0,8129,RS,290
941501_RS_290_290RS070691_00410.jpg,0,1570,1570,RS,290
941502_RS_290_290RS070691_00416.jpg,0,7553,7553,RS,290
941506_RS_290_290RS070691_00435.jpg,0,2154,2154,RS,290
941507_RS_290_290RS070691_00440.jpg,0,7954,7954,RS,290
941508_RS_290_290RS070691_00445.jpg,0,15686,15686,RS,290
941509_RS_290_290RS070691_00450.jpg,6,7671,7677,RS,290
941510_RS_290_290RS070691_00455.jpg,2,7765,7767,RS,290
941511_RS_290_290RS070691_00461.jpg,0,24969,24969,RS,290
941512_RS_290_290RS070691_00465.jpg,19,1416,1435,RS,290
941556_RS_290_290RS070691_00687.jpg,0,14438,14438,RS,290
941557_RS_290_290RS070691_00690.jpg,0,28015,28015,RS,290
941558_RS_290_290RS070691_00695.jpg,0,51350,51350,RS,290
941559_RS_290_290RS070691_00700.jpg,0,8386,8386,RS,290
941570_RS_290_290RS070691_00755.jpg,0,8897,8897,RS,290
941571_RS_290_290RS070691_00760.jpg,0,28718,28718,RS,290
941572_RS_290_290RS070691_00765.jpg,1,84554,84555,RS,290
941579_RS_290_290RS070691_00800.jpg,0,7801,7801,RS,290
941580_RS_290_290RS070691_00805.jpg,0,5365,5365,RS,290
941595_RS_290_290RS070691_00880.jpg,0,44966,44966,RS,290
941598_RS_290_290RS070691_00895.jpg,8,61835,61843,RS,290
941599_RS_290_290RS070691_00900.jpg,0,62397,62397,RS,290
941602_RS_290_290RS070691_00915.jpg,0,27400,27400,RS,290
941603_RS_290_290RS070691_00921.jpg,0,93151,93151,RS,290
941604_RS_290_290RS070691_00925.jpg,0,74863,74863,RS,290
941606_RS_290_290RS070691_00935.jpg,0,69895,69895,RS,290
941607_RS_290_290RS070691_00940.jpg,9,63961,63970,RS,290
941608_RS_290_290RS070691_00945.jpg,0,88282,88282,RS,290
941610_RS_290_290RS070691_00955.jpg,0,108630,108630,RS,290
941611_RS_290_290RS070691_00960.jpg,0,113513,113513,RS,290
941613_RS_290_290RS070691_00970.jpg,0,57231,57231,RS,290
941632_RS_290_290RS070691_01065.jpg,0,16338,16338,RS,290
941637_RS_290_290RS070691_01090.jpg,0,3419,3419,RS,290
941638_RS_290_290RS070691_01095.jpg,0,5924,5924,RS,290
941639_RS_290_290RS070691_01100.jpg,0,19709,19709,RS,290
941640_RS_290_290RS070691_01105.jpg,0,46352,46352,RS,290
941641_RS_290_290RS070691_01111.jpg,0,7503,7503,RS,290
941646_RS_290_290RS070691_01135.jpg,0,1951,1951,RS,290
941647_RS_290_290RS070691_01140.jpg,0,6626,6626,RS,290
941715_RS_290_290RS070691_01480.jpg,0,2327,2327,RS,290
941716_RS_290_290RS070691_01485.jpg,0,9232,9232,RS,290
941802_RS_290_290RS070691_01915.jpg,0,5750,5750,RS,290
941803_RS_290_290RS070691_01920.jpg,0,24010,24010,RS,290
941882_RS_290_290RS070691_02315.jpg,0,2511,2511,RS,290
941883_RS_290_290RS070691_02320.jpg,0,5343,5343,RS,290
941884_RS_290_290RS070691_02325.jpg,0,20172,20172,RS,290
941886_RS_290_290RS070691_02335.jpg,0,1298,1298,RS,290
941887_RS_290_290RS070691_02341.jpg,0,4139,4139,RS,290
941895_RS_290_290RS070691_02380.jpg,0,2355,2355,RS,290
941897_RS_290_290RS070691_02390.jpg,11,18074,18085,RS,290
941899_RS_290_290RS070691_02401.jpg,14,19761,19775,RS,290
941900_RS_290_290RS070691_02405.jpg,0,12308,12308,RS,290
941906_RS_290_290RS070691_02436.jpg,0,2348,2348,RS,290
941907_RS_290_290RS070691_02440.jpg,0,5742,5742,RS,290
941908_RS_290_290RS070691_02446.jpg,0,782,782,RS,290
941909_RS_290_290RS070691_02451.jpg,0,824,824,RS,290
941910_RS_290_290RS070691_02455.jpg,0,2494,2494,RS,290
941912_RS_290_290RS070691_02465.jpg,0,1493,1493,RS,290
941927_RS_290_290RS070691_02540.jpg,0,3427,3427,RS,290
941928_RS_290_290RS070691_02546.jpg,0,11346,11346,RS,290
941929_RS_290_290RS070691_02551.jpg,0,37039,37039,RS,290
941938_RS_290_290RS070691_02595.jpg,0,15804,15804,RS,290
941950_RS_290_290RS070691_02655.jpg,0,6275,6275,RS,290
941971_RS_290_290RS070691_02760.jpg,0,2902,2902,RS,290
941972_RS_290_290RS070691_02765.jpg,0,12255,12255,RS,290
941978_RS_290_290RS070691_02795.jpg,0,1171,1171,RS,290
941979_RS_290_290RS070691_02800.jpg,0,2884,2884,RS,290
942026_RS_290_290RS070691_03035.jpg,0,2342,2342,RS,290
942027_RS_290_290RS070691_03040.jpg,0,5450,5450,RS,290
992772_RS_386_386RS191729_00625.jpg,135,3136,3271,RS,386
992835_RS_386_386RS191729_00940.jpg,577,7713,8290,RS,386
992836_RS_386_386RS191729_00945.jpg,9317,1744,11061,RS,386
992850_RS_386_386RS191729_01015.jpg,103,6025,6128,RS,386
992851_RS_386_386RS191729_01020.jpg,493,15264,15757,RS,386
992865_RS_386_386RS191729_01090.jpg,0,6804,6804,RS,386
992902_RS_386_386RS191729_01275.jpg,0,1182,1182,RS,386
992931_RS_386_386RS191729_01420.jpg,1437,15263,16700,RS,386
993029_RS_386_386RS191729_01910.jpg,7638,2766,10404,RS,386
994075_RS_386_386RS191729_07140.jpg,22519,0,22519,RS,386
994076_RS_386_386RS191729_07145.jpg,23491,0,23491,RS,386
994078_RS_386_386RS191729_07156.jpg,8250,0,8250,RS,386
994079_RS_386_386RS191729_07160.jpg,16258,0,16258,RS,386
994080_RS_386_386RS191729_07165.jpg,14048,0,14048,RS,386
994081_RS_386_386RS191729_07170.jpg,15254,0,15254,RS,386
994082_RS_386_386RS191729_07175.jpg,33645,0,33645,RS,386
994083_RS_386_386RS191729_07180.jpg,20842,0,20842,RS,386
994084_RS_386_386RS191729_07185.jpg,29158,0,29158,RS,386
994085_RS_386_386RS191729_07192.jpg,21249,0,21249,RS,386
994086_RS_386_386RS191729_07195.jpg,19303,0,19303,RS,386
994087_RS_386_386RS191729_07200.jpg,56839,0,56839,RS,386
994088_RS_386_386RS191729_07206.jpg,29579,0,29579,RS,386
994089_RS_386_386RS191729_07210.jpg,25072,0,25072,RS,386
994090_RS_386_386RS191729_07215.jpg,32273,0,32273,RS,386
994091_RS_386_386RS191729_07220.jpg,27439,0,27439,RS,386
994094_RS_386_386RS191729_07236.jpg,21848,0,21848,RS,386
994095_RS_386_386RS191729_07240.jpg,17848,0,17848,RS,386
994096_RS_386_386RS191729_07245.jpg,18394,0,18394,RS,386
994099_RS_386_386RS191729_07260.jpg,21717,0,21717,RS,386
994102_RS_386_386RS191729_07275.jpg,36429,0,36429,RS,386
994103_RS_386_386RS191729_07281.jpg,5153,0,5153,RS,386
994106_RS_386_386RS191729_07295.jpg,9138,0,9138,RS,386
994109_RS_386_386RS191729_07311.jpg,11118,2372,13490,RS,386
994110_RS_386_386RS191729_07315.jpg,9361,9987,19348,RS,386
994128_RS_386_386RS191729_07405.jpg,337,0,337,RS,386
994129_RS_386_386RS191729_07410.jpg,12062,0,12062,RS,386
994132_RS_386_386RS191729_07425.jpg,9751,0,9751,RS,386
994141_RS_386_386RS191729_07470.jpg,1747,0,1747,RS,386
994142_RS_386_386RS191729_07475.jpg,12475,0,12475,RS,386
994145_RS_386_386RS191729_07491.jpg,1386,2445,3831,RS,386
994150_RS_386_386RS191729_07515.jpg,4962,0,4962,RS,386
994151_RS_386_386RS191729_07522.jpg,3395,0,3395,RS,386
994161_RS_386_386RS191729_07570.jpg,2751,0,2751,RS,386
994162_RS_386_386RS191729_07575.jpg,3631,1777,5408,RS,386
994179_RS_386_386RS191729_07660.jpg,47,32709,32756,RS,386
994195_RS_386_386RS191729_07740.jpg,2554,0,2554,RS,386
994198_RS_386_386RS191729_07755.jpg,5873,0,5873,RS,386
994201_RS_386_386RS191729_07770.jpg,12573,0,12573,RS,386
994204_RS_386_386RS191729_07787.jpg,9,3974,3983,RS,386
994414_RS_386_386RS191729_08835.jpg,50870,0,50870,RS,386
994464_RS_386_386RS191729_09085.jpg,5074,0,5074,RS,386
994465_RS_386_386RS191729_09091.jpg,26,1101,1127,RS,386
994466_RS_386_386RS191729_09095.jpg,413,2393,2806,RS,386
994467_RS_386_386RS191729_09101.jpg,54,830,884,RS,386
994469_RS_386_386RS191729_09110.jpg,2709,0,2709,RS,386
994504_RS_386_386RS191729_09285.jpg,3127,0,3127,RS,386
994505_RS_386_386RS191729_09290.jpg,9355,0,9355,RS,386
994518_RS_386_386RS191729_09355.jpg,9324,0,9324,RS,386
994519_RS_386_386RS191729_09361.jpg,9258,0,9258,RS,386
994521_RS_386_386RS191729_09370.jpg,1435,0,1435,RS,386
994527_RS_386_386RS191729_09400.jpg,10381,21148,31529,RS,386
994534_RS_386_386RS191729_09435.jpg,1896,1040,2936,RS,386
994535_RS_386_386RS191729_09440.jpg,13752,0,13752,RS,386
994579_RS_386_386RS191729_09660.jpg,17557,0,17557,RS,386
994582_RS_386_386RS191729_09675.jpg,39759,0,39759,RS,386
994583_RS_386_386RS191729_09680.jpg,55396,0,55396,RS,386
994584_RS_386_386RS191729_09685.jpg,35020,0,35020,RS,386
994585_RS_386_386RS191729_09690.jpg,19894,0,19894,RS,386
994586_RS_386_386RS191729_09695.jpg,10772,0,10772,RS,386
994588_RS_386_386RS191729_09705.jpg,21780,0,21780,RS,386
994590_RS_386_386RS191729_09715.jpg,46138,2669,48807,RS,386
994591_RS_386_386RS191729_09720.jpg,20910,1183,22093,RS,386
994592_RS_386_386RS191729_09725.jpg,4393,0,4393,RS,386
994593_RS_386_386RS191729_09730.jpg,23491,0,23491,RS,386
994594_RS_386_386RS191729_09736.jpg,25879,0,25879,RS,386
994595_RS_386_386RS191729_09740.jpg,22039,0,22039,RS,386
994596_RS_386_386RS191729_09745.jpg,11905,0,11905,RS,386
994597_RS_386_386RS191729_09750.jpg,24700,0,24700,RS,386
994598_RS_386_386RS191729_09755.jpg,52372,0,52372,RS,386
994599_RS_386_386RS191729_09760.jpg,25677,0,25677,RS,386
994601_RS_386_386RS191729_09770.jpg,57720,0,57720,RS,386
994602_RS_386_386RS191729_09775.jpg,53494,0,53494,RS,386
994603_RS_386_386RS191729_09780.jpg,28722,0,28722,RS,386
1008367_RS_386_386RS289112_32760.jpg,5392,3296,8688,RS,386
1014584_RS_386_386RS124739_29845.jpg,13463,65,13528,RS,386
1014612_RS_386_386RS124739_29985.jpg,4533,562,5095,RS,386
1014616_RS_386_386RS124739_30005.jpg,2877,0,2877,RS,386
1014653_RS_386_386RS124739_30190.jpg,15677,11,15688,RS,386
1014682_RS_386_386RS124739_30335.jpg,18187,1,18188,RS,386
1014690_RS_386_386RS124739_30375.jpg,1839,0,1839,RS,386
1014694_RS_386_386RS124739_30395.jpg,11115,0,11115,RS,386
1014701_RS_386_386RS124739_30430.jpg,1263,0,1263,RS,386
1014715_RS_386_386RS124739_30500.jpg,656,43542,44198,RS,386
1014735_RS_386_386RS124739_30601.jpg,330,0,330,RS,386
1014736_RS_386_386RS124739_30605.jpg,2928,0,2928,RS,386
1014738_RS_386_386RS124739_30615.jpg,11020,5250,16270,RS,386
1014744_RS_386_386RS124739_30645.jpg,3299,0,3299,RS,386
1014763_RS_386_386RS124739_30740.jpg,32044,0,32044,RS,386
1014764_RS_386_386RS124739_30745.jpg,28877,0,28877,RS,386
1014779_RS_386_386RS124739_30820.jpg,3313,0,3313,RS,386
1014781_RS_386_386RS124739_30830.jpg,20981,3885,24866,RS,386
1014797_RS_386_386RS124739_30910.jpg,736,69,805,RS,386
1014800_RS_386_386RS124739_30925.jpg,12655,561,13216,RS,386
1014842_RS_386_386RS124739_31135.jpg,26986,96,27082,RS,386
1014860_RS_386_386RS124739_31225.jpg,35482,0,35482,RS,386
1014867_RS_386_386RS124739_31260.jpg,9158,0,9158,RS,386
1014869_RS_386_386RS124739_31270.jpg,3211,1474,4685,RS,386
1014876_RS_386_386RS124739_31306.jpg,10931,10262,21193,RS,386
1014895_RS_386_386RS124739_31400.jpg,20394,0,20394,RS,386
1014904_RS_386_386RS124739_31445.jpg,3270,6499,9769,RS,386
1025716_RS_386_386RS169832_08320.jpg,4695,0,4695,RS,386
1025764_RS_386_386RS169832_08560.jpg,13075,0,13075,RS,386
1025765_RS_386_386RS169832_08565.jpg,24275,0,24275,RS,386
1025772_RS_386_386RS169832_08600.jpg,14874,0,14874,RS,386
1025802_RS_386_386RS169832_08750.jpg,2538,1642,4180,RS,386
1025811_RS_386_386RS169832_08795.jpg,6686,0,6686,RS,386
1025856_RS_386_386RS169832_09020.jpg,712,2104,2816,RS,386
1025858_RS_386_386RS169832_09030.jpg,3136,1054,4190,RS,386
1025859_RS_386_386RS169832_09035.jpg,2934,1220,4154,RS,386
1025882_RS_386_386RS169832_09150.jpg,6779,0,6779,RS,386
1025902_RS_386_386RS169832_09250.jpg,6671,2,6673,RS,386
1025904_RS_386_386RS169832_09260.jpg,10738,0,10738,RS,386
1025910_RS_386_386RS169832_09290.jpg,4269,0,4269,RS,386
1025913_RS_386_386RS169832_09305.jpg,23302,0,23302,RS,386
1046387_DF_060_060BDF0030_01577.jpg,10,11052,11062,DF,060
1047052_DF_060_060BDF0030_02817.jpg,287,1062,1349,DF,060
1051765_DF_020_020BDF0070_01674.jpg,7124,1806,8930,DF,020
1052120_DF_020_020BDF0070_02437.jpg,3647,0,3647,DF,020
1053943_DF_020_020BDF0070_06172.jpg,732,1764,2496,DF,020
1054198_DF_020_020BDF0070_06648.jpg,5939,0,5939,DF,020
1054495_DF_020_020BDF0070_07197.jpg,12,2279,2291,DF,020
1054923_DF_020_020BDF0070_07994.jpg,2400,0,2400,DF,020
1054924_DF_020_020BDF0070_07996.jpg,2104,0,2104,DF,020
1054940_DF_020_020BDF0070_08024.jpg,5307,0,5307,DF,020
1061100_DF_251_251BDF0525_00653.jpg,22,818,840,DF,251
1062514_DF_080_080BDF0032_00044.jpg,9411,9052,18463,DF,080
1066461_DF_010_010BDF0018_00941.jpg,300,800,1100,DF,010
1067948_DF_010_010BDF0018_04055.jpg,104,1091,1195,DF,010
1068090_DF_010_010BDF0018_04321.jpg,28,7409,7437,DF,010
1068449_DF_010_010BDF0018_05113.jpg,1438,6693,8131,DF,010
1075626_DF_251_251BDF0530_02011.jpg,11600,0,11600,DF,251
1075638_DF_251_251BDF0530_02032.jpg,13580,0,13580,DF,251
1075938_DF_251_251BDF0530_02579.jpg,38793,0,38793,DF,251
1076070_DF_251_251BDF0530_02832.jpg,11509,0,11509,DF,251
1076609_DF_251_251BDF0530_03839.jpg,9278,0,9278,DF,251
1077170_DF_251_251BDF0530_04883.jpg,6221,0,6221,DF,251
1077208_DF_251_251BDF0530_04954.jpg,10132,0,10132,DF,251
1077210_DF_251_251BDF0530_04958.jpg,6013,0,6013,DF,251
1078403_DF_010_010BDF0030_1_00189.jpg,44,723,767,DF,010
1081459_DF_080_080BDF0070_00240.jpg,5991,0,5991,DF,080
1081471_DF_080_080BDF0070_00262.jpg,6032,0,6032,DF,080
1081494_DF_080_080BDF0070_00303.jpg,14779,0,14779,DF,080
1081513_DF_080_080BDF0070_00340.jpg,8621,0,8621,DF,080
1081540_DF_080_080BDF0070_00392.jpg,27398,17,27415,DF,080
1081541_DF_080_080BDF0070_00394.jpg,18854,0,18854,DF,080
1081794_DF_080_080BDF0070_00855.jpg,6965,0,6965,DF,080
1081804_DF_080_080BDF0070_00875.jpg,12358,0,12358,DF,080
1082104_DF_080_080BDF0070_01444.jpg,1397,0,1397,DF,080
1082253_DF_080_080BDF0070_01829.jpg,75827,0,75827,DF,080
1083232_DF_080_080BDF0070_03764.jpg,19726,1900,21626,DF,080
1083760_DF_080_080BDF0090_00307.jpg,2096,0,2096,DF,080
1084106_DF_080_080BDF0090_00986.jpg,23752,0,23752,DF,080
1084276_DF_080_080BDF0090_01376.jpg,7583,0,7583,DF,080
1084417_DF_080_080BDF0090_01630.jpg,7744,0,7744,DF,080
1085370_DF_080_080BDF0090_03489.jpg,6265,0,6265,DF,080
1085407_DF_080_080BDF0090_03558.jpg,18420,77,18497,DF,080
1090136_DF_070_070BDF0050_05561.jpg,563,947,1510,DF,070
1090285_DF_070_070BDF0050_05833.jpg,4181,0,4181,DF,070
1090502_DF_070_070BDF0050_06236.jpg,8053,0,8053,DF,070
1091611_DF_251_251BDF0490_00586.jpg,5143,0,5143,DF,251
1091701_DF_251_251BDF0490_00756.jpg,8581,0,8581,DF,251
1091712_DF_251_251BDF0490_00776.jpg,8435,0,8435,DF,251
1091721_DF_251_251BDF0490_00794.jpg,8738,0,8738,DF,251
1091745_DF_251_251BDF0490_00840.jpg,10190,0,10190,DF,251
1091752_DF_251_251BDF0490_00854.jpg,4814,0,4814,DF,251
1091815_DF_251_251BDF0490_00971.jpg,8676,0,8676,DF,251
1091831_DF_251_251BDF0490_01002.jpg,13279,0,13279,DF,251
1091936_DF_251_251BDF0490_01202.jpg,13852,0,13852,DF,251
1091963_DF_251_251BDF0490_01252.jpg,14329,0,14329,DF,251
1091983_DF_251_251BDF0490_01289.jpg,12692,0,12692,DF,251
1091992_DF_251_251BDF0490_01304.jpg,871,0,871,DF,251
1092008_DF_251_251BDF0490_01335.jpg,5979,16,5995,DF,251
1092317_DF_251_251BDF0490_01901.jpg,14994,364,15358,DF,251
1092318_DF_251_251BDF0490_01903.jpg,24106,962,25068,DF,251
1092481_DF_251_251BDF0052_00028.jpg,108546,0,108546,DF,251
1092557_DF_251_251BDF0052_00172.jpg,6032,0,6032,DF,251
1092758_DF_251_251BDF0052_00520.jpg,19366,0,19366,DF,251
1092801_DF_251_251BDF0052_00593.jpg,30123,0,30123,DF,251
1092810_DF_251_251BDF0052_00610.jpg,16816,0,16816,DF,251
1092812_DF_251_251BDF0052_00613.jpg,26235,0,26235,DF,251
1092817_DF_251_251BDF0052_00622.jpg,22105,0,22105,DF,251
1092829_DF_251_251BDF0052_00643.jpg,18968,0,18968,DF,251
1092831_DF_251_251BDF0052_00646.jpg,12951,1111,14062,DF,251
1092835_DF_251_251BDF0052_00654.jpg,31630,0,31630,DF,251
1092837_DF_251_251BDF0052_00656.jpg,19411,0,19411,DF,251
1092848_DF_251_251BDF0052_00676.jpg,31387,0,31387,DF,251
1092850_DF_251_251BDF0052_00679.jpg,27309,0,27309,DF,251
1092855_DF_251_251BDF0052_00689.jpg,23075,0,23075,DF,251
1092859_DF_251_251BDF0052_00695.jpg,21147,0,21147,DF,251
1092870_DF_251_251BDF0052_00715.jpg,27268,0,27268,DF,251
1092899_DF_251_251BDF0052_00766.jpg,2333,1786,4119,DF,251
1092905_DF_251_251BDF0052_00777.jpg,55400,0,55400,DF,251
1092908_DF_251_251BDF0052_00782.jpg,20799,0,20799,DF,251
1092909_DF_251_251BDF0052_00784.jpg,13776,0,13776,DF,251
1092963_DF_251_251BDF0052_00879.jpg,19811,0,19811,DF,251
1092964_DF_251_251BDF0052_00881.jpg,33336,0,33336,DF,251
1092999_DF_251_251BDF0052_00943.jpg,25519,0,25519,DF,251
1093019_DF_251_251BDF0052_00978.jpg,21970,0,21970,DF,251
1093204_DF_251_251BDF0052_01335.jpg,8827,3,8830,DF,251
1093257_DF_251_251BDF0052_01427.jpg,1353,682,2035,DF,251
1093258_DF_251_251BDF0052_01429.jpg,10953,0,10953,DF,251
1093967_DF_251_251BDF0052_02692.jpg,4819,964,5783,DF,251
1093968_DF_251_251BDF0052_02694.jpg,10330,422,10752,DF,251
1094003_DF_251_251BDF0052_02758.jpg,15458,0,15458,DF,251
1094278_DF_251_251BDF0052_03273.jpg,12299,0,12299,DF,251
1095847_DF_070_070BDF0010_01637.jpg,3673,0,3673,DF,070
1096019_DF_070_070BDF0010_01956.jpg,4276,11649,15925,DF,070
1097209_DF_070_070BDF0010_04090.jpg,1007,760,1767,DF,070
1097236_DF_070_070BDF0010_04137.jpg,5831,2473,8304,DF,070
733864_ES_482_482ES014500_06030.jpg,67,389,456,ES,482
765204_ES_259_259ES000000_00120.jpg,1171,151,1322,ES,259
765236_ES_259_259ES000000_00280.jpg,3714,105,3819,ES,259
765254_ES_259_259ES000000_00370.jpg,5427,3707,9134,ES,259
765877_ES_259_259ES000000_03485.jpg,9241,0,9241,ES,259
774885_ES_259_259ES000000_48525.jpg,187,0,187,ES,259
820313_ES_259_259ES000000_03050.jpg,70,3668,3738,ES,259
883067_RS_290_290RS150131_16065.jpg,17,49006,49023,RS,290
883083_RS_290_290RS150131_16145.jpg,0,62263,62263,RS,290
883234_RS_290_290RS150131_16900.jpg,10,22593,22603,RS,290
883242_RS_290_290RS150131_16940.jpg,0,56221,56221,RS,290
883277_RS_290_290RS150131_17115.jpg,174,31177,31351,RS,290
884192_RS_290_290RS150131_21690.jpg,144,9877,10021,RS,290
884194_RS_290_290RS150131_21700.jpg,1,19810,19811,RS,290
916112_RS_290_290RS294095_14010.jpg,8631,11,8642,RS,290
916163_RS_290_290RS294095_14266.jpg,890,0,890,RS,290
916321_RS_290_290RS294095_15055.jpg,0,867,867,RS,290
916443_RS_290_290RS294095_15665.jpg,1127,0,1127,RS,290
916636_RS_290_290RS294095_16630.jpg,9061,0,9061,RS,290
916673_RS_290_290RS294095_16815.jpg,0,5292,5292,RS,290
916870_RS_290_290RS294095_17800.jpg,10665,605,11270,RS,290
917089_RS_290_290RS294095_18895.jpg,4507,0,4507,RS,290
917118_RS_290_290RS294095_19040.jpg,9401,0,9401,RS,290
917130_RS_290_290RS294095_19100.jpg,17880,0,17880,RS,290
917140_RS_290_290RS294095_19150.jpg,2748,0,2748,RS,290
917154_RS_290_290RS294095_19220.jpg,10068,0,10068,RS,290
917156_RS_290_290RS294095_19230.jpg,7578,0,7578,RS,290
917205_RS_290_290RS294095_19475.jpg,39066,0,39066,RS,290
917213_RS_290_290RS294095_19515.jpg,19911,8,19919,RS,290
917227_RS_290_290RS294095_19585.jpg,9629,0,9629,RS,290
917235_RS_290_290RS294095_19625.jpg,12838,0,12838,RS,290
917248_RS_290_290RS294095_19690.jpg,45158,0,45158,RS,290
917288_RS_290_290RS294095_19891.jpg,8519,0,8519,RS,290
917306_RS_290_290RS294095_19980.jpg,6226,0,6226,RS,290
917308_RS_290_290RS294095_19990.jpg,5796,0,5796,RS,290
917399_RS_290_290RS294095_20445.jpg,16764,0,16764,RS,290
917416_RS_290_290RS294095_20530.jpg,9434,0,9434,RS,290
917441_RS_290_290RS294095_20655.jpg,12218,116,12334,RS,290
917449_RS_290_290RS294095_20695.jpg,11963,0,11963,RS,290
917495_RS_290_290RS294095_20925.jpg,4007,3526,7533,RS,290
917531_RS_290_290RS294095_21105.jpg,8063,0,8063,RS,290
917673_RS_290_290RS294095_21815.jpg,404,19279,19683,RS,290
917784_RS_290_290RS294095_22370.jpg,13306,1,13307,RS,290
917802_RS_290_290RS294095_22460.jpg,6329,1782,8111,RS,290
917806_RS_290_290RS294095_22480.jpg,4894,0,4894,RS,290
917837_RS_290_290RS294095_22635.jpg,2382,0,2382,RS,290
917904_RS_290_290RS294095_22970.jpg,9690,0,9690,RS,290
917905_RS_290_290RS294095_22975.jpg,6976,0,6976,RS,290
918130_RS_290_290RS294095_24100.jpg,3246,0,3246,RS,290
918229_RS_290_290RS294095_24595.jpg,9890,0,9890,RS,290
918922_RS_290_290RS294095_28060.jpg,3282,0,3282,RS,290
919128_RS_290_290RS294095_29090.jpg,10821,0,10821,RS,290
919140_RS_290_290RS294095_29150.jpg,8869,0,8869,RS,290
919164_RS_290_290RS294095_29271.jpg,14922,0,14922,RS,290
919196_RS_290_290RS294095_29430.jpg,7887,0,7887,RS,290
919207_RS_290_290RS294095_29485.jpg,3306,0,3306,RS,290
919215_RS_290_290RS294095_29525.jpg,18676,0,18676,RS,290
919218_RS_290_290RS294095_29540.jpg,7182,0,7182,RS,290
919258_RS_290_290RS294095_29740.jpg,2835,0,2835,RS,290
919349_RS_290_290RS294095_30195.jpg,76,928,1004,RS,290
919398_RS_290_290RS294095_30440.jpg,5123,0,5123,RS,290
919413_RS_290_290RS294095_30515.jpg,14512,0,14512,RS,290
919562_RS_290_290RS294095_31260.jpg,29293,0,29293,RS,290
919633_RS_290_290RS294095_31617.jpg,5039,0,5039,RS,290
919716_RS_290_290RS294095_32030.jpg,7892,0,7892,RS,290
919721_RS_290_290RS294095_32055.jpg,15256,0,15256,RS,290
919726_RS_290_290RS294095_32080.jpg,15135,0,15135,RS,290
919762_RS_290_290RS294095_32260.jpg,13347,0,13347,RS,290
919769_RS_290_290RS294095_32295.jpg,15165,0,15165,RS,290
919807_RS_290_290RS294095_32486.jpg,9046,3582,12628,RS,290
941505_RS_290_290RS070691_00430.jpg,0,3685,3685,RS,290
941555_RS_290_290RS070691_00680.jpg,1,3556,3557,RS,290
941636_RS_290_290RS070691_01085.jpg,278,1548,1826,RS,290
941801_RS_290_290RS070691_01911.jpg,0,3174,3174,RS,290
941901_RS_290_290RS070691_02410.jpg,0,7024,7024,RS,290
941948_RS_290_290RS070691_02645.jpg,0,2584,2584,RS,290
942028_RS_290_290RS070691_03045.jpg,25,20557,20582,RS,290
994077_RS_386_386RS191729_07150.jpg,21582,0,21582,RS,386
994093_RS_386_386RS191729_07230.jpg,18499,75,18574,RS,386
994100_RS_386_386RS191729_07265.jpg,23741,0,23741,RS,386
994101_RS_386_386RS191729_07270.jpg,18218,0,18218,RS,386
994144_RS_386_386RS191729_07485.jpg,3805,753,4558,RS,386
994169_RS_386_386RS191729_07610.jpg,8451,3137,11588,RS,386
994203_RS_386_386RS191729_07783.jpg,4024,1485,5509,RS,386
994510_RS_386_386RS191729_09315.jpg,4476,0,4476,RS,386
994528_RS_386_386RS191729_09405.jpg,4419,10981,15400,RS,386
994604_RS_386_386RS191729_09785.jpg,20542,0,20542,RS,386
